Wo, Wo, Ww, Ww, Gs, Gs, Gs, Gs, Gs, Re, Re, Gs^Fds, Gs, Gs^Fds, Gs^Fds, Gs, Gg, Hh^Fds, Hh^Fds, Hh^Fds, Mm, Mm, Mm, Mm, Mm, Hh, Mm, Mm, Mm, Mm, Mm, Mm, Mm, Mm, Mm, Mm, Mm
Wo, Wo, Ww, Ww, Gs^Vh, Gs, Gs, Gs, Gs, Re, Re, Gs^Fds, Gs, Gs^Fds, Gs^Fds, Gs, Gg^Vh, Hh^Fds, Hh^Fds, Hh^Fds, Mm, Mm, Mm, Mm, Mm, Hh^Vhh, Mm, Mm, Mm, Mm, Mm, Mm, Mm, Mm, Mm, Mm, Mm
Ww, Ww, Gs^Vh, Gs, Gs, Mm, Ce, Gs, Ce, Gs, Re, Gs, Gs^Fds, Gs^Fds, Mm, Mm, Mm, Mm, Mm, Hh^Fds, Mm, Mm, Ww, Mm, Mm, Mm, Mm, Mm, Mm, Gs, Mm, Mm, Mm, Mm, Mm, Mm, Mm
Gs, Gs, Gs^Fds, Gs^Fds, Gs, Mm, Ce, 3 Ke, Ce, Gs, Re, Gs, Gs^Vh, Gs^Fds, Mm, Mm, Mm, Mm, Mm, Mm, Mm, Mm, Ww, Mm, Mm, Mm, Mm, Mm, Mm, Mm, Mm, Mm, Mm, Mm, Mm, Mm, Mm
Gs^Fds, Gs^Fds, Gs, Gs^Fds, Gs, Mm, Mm, Hh, Hh, Gs, Hh, Re, Hh, Gs, Mm, Mm, Mm, Mm, Mm, Mm, Mm, Ww, Ww, Gs, Gs, Mm, Hh, Hh, Hh, Hh, Hh, Hh, Ww, Ww, Mm, Mm, Mm
Gs^Fds, Gs^Fds, Mm, Gs, Gs^Vh, Gs, Mm, Mm, Mm, Hh, Hh, Re, Hh, Mm, Mm, Mm, Mm, Mm, Hh, Hh, Hh, Ww, Hh, Gg^Vh, Gs, Hh, Hh^Fds, Hh, Hh, Gs, Gg^Vh, Gs^Fds, Ww, Mm, Mm, Mm, Mm
Mm, Mm, Mm, Mm, Mm, Mm, Mm, Mm, Mm, Mm, Hh, Re, Hh, Mm, Mm, Mm, Mm, Hh, Hh, Hh, Hh^Fds, Ww, Hh^Fds, Hh^Fds, Gs^Fds, Gs^Fds, Gs^Fds, Hh^Fds, Gs^Fds, Gs, Ww, Ww, Hh^Fds, Mm, Mm, Mm, Mm
Mm, Mm, Mm, Mm, Mm, Mm, Mm, Mm, Mm, Hh, Hh, Re, Hh, Hh, Hh, Mm, Hh, Hh, Hh, Hh, Gs^Fds, Ww, Ww, Gg, Ww, Gs^Fds, Gs^Fds, Re, Gs^Fds, Ww, Gs^Fds, Hh^Fds, Hh^Fds, Mm, Mm, Mm, Mm
Mm^Xm, Mm^Xm, Mm^Xm, Mm, Mm, Mm, Mm, Mm, Mm, Mm, Hh, Re, Re, Hh, Mm, Mm, Hh, Hh^Fds, Hh^Fds, Hh^Fds, Gs^Fds, Gs^Fds, Ww, Ww, Ww, Gg, Gg, Gs^Fds, Ww, Ww, Gs^Fds, Gs^Fds, Hh^Fds, Hh^Fds, Hh^Fds, Mm, Mm
Mm^Xm, Mm^Xm, Mm^Xm, Mm^Xm, Mm, Mm, Mm, Mm, Mm, Hh^Fds, Hh, Hh, Re, Hh, Hh, Hh, Hh, Hh, Gs^Fds, Gs^Fds, Gs^Fds, Gs^Fds, Gg^Vh, Ww, Ww, Ww, Ww, Ww, Ww, Gg, Gg, Gs^Fds, Gs, Gs^Fds, Mm, Mm, Mm
Mm^Xm, Mm^Xm, Mm^Xm, Mm, Mm, Mm, Mm, Mm, Mm, Hh, Hh^Fds, Hh, Re, Hh, Gs, Gs, Gs, Gs, Gs^Fds, Gs^Fds, Gs^Fds, Gs^Fds, Ww, Ww, Ww, Ww, Wo, Ww, Ww, Ww, Gs^Fds, Gs^Fds, Gs^Fds, Mm, Mm, Mm, Mm
Mm^Xm, Mm^Xm, Mm^Xm, Mm, Mm^Xm, Mm, Mm, Mm, Mm, Mm, Gs^Fds, Gs^Fds, Gs, Re, Re, Gg, Gg, Gg, Gg, Gg, Ww, Ww, Wo, Ww, Wo, Wo, Wo, Ww, Ww^Bw\, Gg, Gs^Fds, Gs^Fds, Gs^Fds, Gs^Fds, Gg, Mm, Mm
Mm^Xm, Mm^Xm, Mm, Mm, Mm, Mm, Mm, Mm, Mm, Gs^Fds, Hh, Gs^Fds, Gs, Gg, Re, Gg^Vh, Gg, Gg, Gg, Gg, Ww, Ww, Wo, Wo, Wo, Wo, Wo, Ww, Ww, Gg^Vh, Gg, Gg, Gg, Gs^Fds, Gg^Vh, Mm, Mm
Mm^Xm, Mm^Xm, Mm, Mm, Mm, Mm, Mm, Mm, Mm, Mm, Mm, Hh, Hh^Fds, Gs, Gg, Re, Re, Gg, Gs^Fds, Gg, Ww, Wo, Wo, Wo, Ww, Wo, Wo, Wo, Wo, Wo, Wo, Gg, Gg, Gg, Mm, Mm, Mm
Mm, Mm, Mm, Mm, Mm, Mm, Hh^Fds, Mm, Hh^Fds, Mm, Mm, Hh, Hh, Gs, Gg, Gg, Re, Gg, Gs^Fds, Ww, Wo, Wo, Ww, Ww, Gg, Ww, Wo, Ch, 1 Kh, Ch, Gg, Gg, Gs^Fds, Gg, Mm, Mm, Mm
Mm, Mm, Mm, Mm, Mm, Hh^Fds, Gs^Fds, Gs^Fds, Gs^Fds, Mm, Hh, Hh, Hh, Gs, Gs, Gg, Re, Gs^Fds, Ww, Ww, Ww, Wo, Ww, Ww, Gg, Ww, Gg, Ch, 2 Ch, Ch, Gg, Gg, Gg, Gs^Fds, Gs, Mm, Mm
Mm, Mm, Mm, Mm, Hh^Fds, Hh^Fds, Gs^Fds, Gg^Vh, Ww, Gs^Fds, Ww, Hh, Hh, Hh, Gs, Gg, Gg, Re, Ww, Ww, Gg, Ww, Gg^Vh, Gs^Fds, Gg, Gg, Gg, Gg, Rr, Gg, Gs^Fds, Gs^Fds, Mm, Gs^Fds, Gg^Vh, Mm, Mm
Mm, Mm, Mm, Mm, Hh^Fds, Hh^Fds, Gs^Fds, Ww, Ww, Ss, Ww, Gs, Gs, Gs, Gg, Gg, Gg, Re, Gg^Vh, Ww, Gg, Gs^Fds, Gs^Fds, Gs^Fds, Gg, Gg, Rr, Rr, Gg, Gg, Gs, Mm, Mm, Mm, Mm, Mm, Mm
Mm, Mm, Mm, Mm, Hh^Fds, Hh^Fds, Gs^Fds, Ss, Gs^Fds, Ss, Ss, Gs^Fds, Gs, Hh, Gg, Gg, Gg, Re, Gg, Ww, Gg, Gs^Fds, Gs^Fds, Gg, Rr, Rr, Gg^Vh, Re, Gg, Gg, Gg^Vh, Mm, Mm, Mm, Mm, Mm, Mm
Mm, Mm, Mm, Hh, Hh, Gg^Vh, Hh, Gs^Fds, Gs^Fds, Ss, Ww, Ss, Re, Gs^Vh, Re, Gg, Re, Re, Ww, Ww, Gg, Gg, Gg, Gg, Rr, Gg, Re, Re, Gg, Hh^Fds, Hh^Fds, Mm, Mm, Mm, Mm, Gs, Mm
Mm, Mm, Mm, Hh, Hh, Hh, Hh, Gs, Gs, Gs^Fds, Re, Ww^Bw/, Ww, Re, Ss, Re, Ss, Re, Ww^Bw\, Gg, Rr, Gg, Rr, Rr, Gg, Re, Gg, Gs^Fds, Gs^Fds, Hh^Fds, Hh^Fds, Mm, Mm, Mm, Mm, Mm, Mm
Mm, Mm, Mm, Mm, Mm, Hh, Hh, Hh, Re, Re, Hh, Gs^Vh, Ss, Ss, Ss, Ss, Ss, Ww, Gg, Rr, Gg^Vh, Rr, Gs, Gs, Gs, Gg, Gs^Fds, Gs^Fds, Mm, Hh^Fds, Mm, Hh^Fds, Mm, Mm, Mm, Mm, Mm
Mm, Mm, Mm, Mm, Hh, Hh, Hh, Re, Gs, Hh, Hh, Ww, Ww, Ww, Ss, Ss, Ss, Ss, Hh^Fds, Hh, Hh, Gs, Mm, Mm, Mm, Gs, Mm, Mm, Mm, Mm, Mm, Mm, Mm, Mm, Mm, Mm, Mm
Mm, Mm, Mm, Mm, Ce, Hh, Re, Re, Re, Gs^Vh, Hh, Hh, Hh, Ww, Gs, Gs, Mm, Gs^Fds, Gs^Fds, Hh^Fds, Hh, Mm, Mm, Mm, Mm, Mm, Mm, Mm, Mm, Mm, Mm, Mm, Mm, Mm, Mm, Mm, Mm
Mm, Mm, Mm, Ce, Ce, Re, Hh, Hh, Hh, Re, Ch, Mm, Mm, Hh, Mm, Gs, Mm, Gs^Fds, Mm, Mm, Mm, Mm, Mm, Mm, Mm, Mm, Mm, Mm, Mm, Mm, Gs, Mm, Mm, Mm, Mm, Mm, Mm
Mm, Mm, Mm, Mm, Mm, Hh, Mm, Mm, Ch, Re, Re, Hh, Mm, Mm, Mm, Mm, Mm, Mm, Mm, Mm, Mm, Mm, Mm, Mm, Mm, Mm, Mm, Mm, Mm, Mm, Mm, Gs^Vh, Mm, Mm, Mm, Mm, Mm
Mm, Mm, Mm, Mm, Mm, Mm, Mm, Mm, Hh, Re, Re, Hh, Mm, Mm, Mm, Mm, Mm, Mm, Mm, Mm, Mm, Mm, Mm, Mm, Mm, Mm, Mm, Mm, Mm, Mm, Mm, Mm, Mm, Mm, Mm, Mm, Mm
