Ai, Ai, Ai, Ai, Aa, Aa, Aa, Aa, Re, Re, Aa, Aa^Fda, Aa, Aa^Fda, Aa^Fda, Aa, Aa, Ha^Fda, Ha^Fda, Ha^Fda, Mm, Mm, Mm, Mm, Mm, Hh, Mm, Mm, Mm, Mm, Mm, Mm, Mm, Ce, Ce, Ce, Ce
Ai, Ai, Ai, Ai, Aa^Vha, Aa, Aa, Aa, Re, Re, Aa, Aa^Fda, Aa, Aa^Fda, Aa^Fda, Aa, Aa^Vha, Ha^Fda, Ha^Fda, Ha^Fda, Mm, Mm, Mm, Mm, Mm, Ha^Vhha, Mm, Mm, Mm, Mm, Mm, Mm, Mm, Ce, 5 Ke, Ce, Ce
Ai, Ai, Aa^Vha, Aa, Aa, Mm, Ce, Re, Ce, Re, Re, Aa, Aa^Fda, Aa^Fda, Mm, Mm, Mm, Mm, Mm, Ha^Fda, Mm, Mm, Ai, Mm, Mm, Mm, Mm, Mm, Mm, Aa, Mm, Mm, Mm, Mm, Mm, Ce, Ce
Aa, Aa, Aa^Fda, Aa^Fda, Aa, Mm, Ce, 4 Ke, Ce, Aa, Re, Aa, Aa^Vha, Aa^Fda, Mm, Mm, Mm, Mm, Mm, Mm, Mm, Mm, Ai, Mm, Mm, Mm, Mm, Mm, Mm, Mm, Mm, Mm, Mm, Mm, Mm, Mm, Mm
Aa^Fda, Aa^Fda, Aa, Aa^Fda, Aa, Mm, Mm, Ha, Ha, Aa, Ha, Re, Ha, Aa, Mm, Mm, Mm, Mm, Mm, Mm, Mm, Ai, Ai, Aa, Aa, Mm, Ha, Ha, Ha, Ha, Ha, Ha, Ai, Ai, Mm, Mm, Mm
Aa^Fda, Aa^Fda, Mm, Aa, Aa^Vha, Aa, Mm, Mm, Mm, Ha, Ha, Re, Ha, Mm, Mm, Mm, Mm, Mm, Ha, Ha, Ha, Ai, Ha, Aa^Vha, Aa, Ha, Ha^Fda, Ha, Ha, Aa, Aa^Vha, Aa^Fda, Ai, Mm, Mm, Mm, Mm
Mm, Mm, Mm, Mm, Mm, Mm, Mm, Mm, Mm, Mm, Chr, Re, Chr, Mm, Mm, Mm, Mm, Ha, Ha, Ha, Ha^Fda, Ai, Ha^Fda, Ha^Fda, Aa^Fda, Aa^Fda, Aa^Fda, Ha^Fda, Aa^Fda, Aa, Ai, Ai, Ha^Fda, Mm, Mm, Mm, Mm
Mm, Mm, Mm, Mm, Mm, Mm, Mm, Mm, Mm, Ha, Ha, Re, Ha, Ha, Ha, Mm, Ha, Ha, Ha, Ha, Aa^Fda, Ai, Ai, Gll, Ai, Aa^Fda, Aa^Fda, Gll, Aa^Fda, Ai, Aa^Fda, Ha^Fda, Ha^Fda, Mm, Mm, Mm, Mm
Mm^Xm, Mm^Xm, Mm^Xm, Mm, Mm, Mm, Mm, Mm, Mm, Mm, Ha, Re, Re, Ha, Mm, Mm, Ha, Ha^Fda, Ha^Fda, Ha^Fda, Aa^Fda, Aa^Fda, Ai, Ai, Ai, Gll, Gll, Aa^Fda, Ai, Ai, Aa^Fda, Aa^Fda, Ha^Fda, Ha^Fda, Ha^Fda, Mm, Mm
Mm^Xm, Mm^Xm, Mm^Xm, Mm^Xm, Mm, Mm, Mm, Mm, Mm, Ha^Fda, Ha, Ha, Re, Ha, Ha, Ha, Ha, Ha, Aa^Fda, Aa^Fda, Aa^Fda, Aa^Fda, Aa^Vha, Ai, Ai, Ww, Ww, Ai, Ai, Gll, Gll, Aa^Fda, Gll, Aa^Fda, Mm, Mm, Mm
Mm^Xm, Mm^Xm, Mm^Xm, Mm, Mm, Mm, Mm, Mm, Mm, Ha, Ha^Fda, Ha, Re, Ha, Gll, Aa, Gll, Gll, Gll^Fdw, Gll^Fdw, Gll^Fdw, Aa^Fda, Ww, Ai, Ww, Ww, Wo, Ww, Ww, Ww, Gll^Fdw, Aa^Fda, Aa^Fda, Mm, Mm, Mm, Mm
Mm^Xm, Mm^Xm, Mm^Xm, Mm, Mm^Xm, Mm, Mm, Mm, Mm, Mm, Aa^Fda, Aa^Fda, Aa, Re, Re, Gll, Gd, Gd, Gs, Gd, Ww, Ww, Wo, Ww, Wo, Wo, Wo, Ww, Ww^Bw\, Gll, Gll^Fdw, Gll^Fdw, Gll^Fdw, Aa^Fda, Aa, Mm, Mm
Mm^Xm, Mm^Xm, Mm, Mm, Mm, Mm, Mm, Mm, Mm, Aa^Fda, Hhd, Aa^Fda, Gll, Gll, Re, Gs^Vh, Gd, Gs, Gd, Gd, Ww, Ww, Wo, Wo, Wo, Wo, Wo, Ww, Ww, Gd^Vh, Gd, Gd, Gll, Gll^Fdw, Gd^Vh, Mm, Mm
Mm^Xm, Mm^Xm, Mm, Mm, Mm, Mm, Mm, Mm, Mm, Mm, Mm, Hhd, Hhd^Fdw, Gd, Gd, Re, Re, Gd, Gs^Fdw, Gd, Ww, Wo, Wo, Wo, Ww, Wo, Wo, Wo, Wo, Wo, Wo, Gll, Gd, Gll, Mm, Mm, Mm
Mm, Mm, Mm, Mm, Mm, Mm, Hhd^Fdw, Mm, Hhd^Fdw, Mm, Mm, Hhd, Hhd, Gll, Gs, Gd, Re, Gd, Gs^Fdf, Ww, Wo, Wo, Ww, Ww, Gd, Ww, Wo, Ch, 1 Kh, Ch, Gs, Gll, Gd^Fdw, Gd, Mm, Mm, Mm
Mm, Mm, Mm, Mm, Mm, Hhd^Fdw, Gll^Fdf, Gd^Fdw, Gd^Fdf, Mm, Hhd, Hhd, Hhd, Gd, Gd, Gd, Re, Ch, Ww, Ww, Ww, Wo, Ww, Ww, Gd, Ww, Gs, Ch, 2 Ch, Ch, Gd, Gd, Gd, Gd^Fdf, Gs, Mm, Mm
Mm, Mm, Mm, Mm, Hhd^Fdw, Hhd^Fdf, Gd^Fdw, Gd^Vh, Ww, Gll^Fdw, Ww, Hhd, Hhd, Hhd, Gd, Ch, Gd, Re, Ww, Ww, Gd, Ww, Gs^Vh, Gs^Fdf, Gd, Gd, Gd, Gd, Rr, Gd, Gll^Fdf, Gll^Fdf, Mm, Gd^Fdw, Gd^Vh, Mm, Mm
Mm, Mm, Mm, Mm, Hhd^Fdf, Hhd^Fdf, Gll^Fdf, Ww, Ww, Ss, Ww, Gll, Gd, Gd, Gd, Gd, Gd, Re, Gd^Vh, Ww, Gd, Gs^Fdf, Gs^Fdf, Gs^Fdf, Gd, Gd, Rr, Rr, Gd, Gd, Gll, Mm, Mm, Mm, Mm, Mm, Mm
Mm, Mm, Mm, Mm, Hhd^Fdf, Hhd^Fdf, Gll^Fdf, Ss, Gll^Fdf, Ss, Ss, Gll^Fdw, Gll, Hhd, Gd, Gd, Gd, Re, Gd, Ww, Gd, Gs^Fdf, Gs^Fdf, Gd, Rr, Rr, Gd^Vh, Re, Gd, Gd, Gs^Vh, Mm, Mm, Mm, Mm, Mm, Mm
Mm, Mm, Mm, Hhd, Hhd, Gll^Vh, Hhd, Gll^Fdf, Gll^Fdf, Ss, Ww, Ss, Re, Gd^Vh, Re, Gd, Re, Re, Ww, Ww, Gd, Gd, Gd, Gd, Rr, Gd, Re, Re, Gd, Hhd^Fdf, Hhd^Fdf, Mm, Mm, Mm, Mm, Gs, Mm
Mm, Mm, Mm, Hhd, Hhd, Hhd, Hhd, Gll, Gll, Gll^Fdf, Re, Ww^Bw/, Ww, Re, Ss, Re, Ss, Re, Ww^Bw\, Gd, Rr, Gd, Rr, Rr, Gd, Re, Gd, Gll^Fdf, Gll^Fdf, Hhd^Fdf, Hhd^Fdf, Mm, Mm, Mm, Mm, Mm, Mm
Mm, Mm, Mm, Mm, Mm, Hhd, Hhd, Hhd, Re, Re, Hhd, Gg^Vh, Ss, Ss, Ss, Ss, Ss, Ww, Gd, Rr, Gd^Vh, Rr, Gd, Gd, Gd, Gd, Gll^Fdf, Gll^Fdf, Mm, Hhd^Fdf, Mm, Hhd^Fdf, Mm, Mm, Mm, Mm, Mm
Mm, Mm, Mm, Mm, Ce, Hhd, Hhd, Re, Gd, Hhd, Hhd, Ww, Ww, Ww, Ss, Ss, Ss, Ss, Hhd^Fdf, Hhd, Hhd, Gd, Mm, Mm, Mm, Gd, Mm, Mm, Mm, Mm, Mm, Mm, Mm, Mm, Mm, Mm, Mm
Mm, Mm, Mm, Mm, 3 Ke, Ce, Re, Re, Re, Gd^Vh, Hhd, Hhd, Hhd, Ww, Gll, Gs, Mm, Gd^Fdf, Gs^Fdf, Hhd^Fdf, Hhd, Mm, Mm, Mm, Mm, Mm, Mm, Mm, Mm, Mm, Mm, Mm, Mm, Mm, Mm, Mm, Mm
Mm, Mm, Mm, Ce, Ce, Re, Hhd, Hhd, Hhd, Re, Ch, Mm, Mm, Hhd, Mm, Gd, Mm, Gs^Fdf, Mm, Mm, Mm, Mm, Mm, Mm, Mm, Mm, Mm, Mm, Mm, Mm, Gd, Mm, Mm, Mm, Mm, Mm, Mm
Mm, Mm, Mm, Mm, Mm, Hhd, Mm, Mm, Ch, Re, Re, Hhd, Mm, Mm, Mm, Mm, Mm, Mm, Mm, Mm, Mm, Mm, Mm, Mm, Mm, Mm, Mm, Mm, Mm, Mm, Mm, Gd^Vh, Mm, Mm, Mm, Mm, Mm
Mm, Mm, Mm, Mm, Mm, Mm, Mm, Mm, Hhd, Re, Re, Hhd, Mm, Mm, Mm, Mm, Mm, Mm, Mm, Mm, Mm, Mm, Mm, Mm, Mm, Mm, Mm, Mm, Mm, Mm, Mm, Mm, Mm, Mm, Mm, Mm, Mm
