Mm, Mm, Mm, Mm, Mm, Mm, Mm, Mm, Mm, Mm, Mm, Mm, Mm, Mm, Mm, Mm, Mm, Mm, Mm, Mm, Mm, Mm, Mm, Mm, Hhd, Hhd^Fdf, Gd^Fdf, Re, Hhd^Fdf, Hhd^Fdf, Mm, Mm
Mm, Mm, Mm, Mm, Mm, Mm, Mm, Mm, Mm, Mm, Mm, Mm, Mm, Mm, Mm, Mm, Mm, Mm, Mm, Mm, Mm, Mm, Mm, Mm, Hhd, Hhd^Fdw, Gd^Fdw, Re, Gd^Fdw, Hhd^Fdw, Mm, Mm
Mm, Mm, Mm, Mm, Mm, Mm, Mm, Mm, Mm, Mm, Mm, Mm, Mm, Mm, Mm, Mm, Mm, Mm, Mm, Mm, Mm, Mm, Mm, Hhd, Hhd, Hhd^Fdf, Re, Re, Gd^Fdf, Hhd^Fdf, Mm, Mm
Mm, Mm, Mm, Mm, Mm, Mm, Mm, Mm, Mm, Mm, Mm, Mm, Mm, Mm, Mm, Mm, Mm, Mm, Mm, Mm, Mm, Mm, Mm, Hhd, Hhd, Gd^Fdf, Re, Gd^Fdw, Hhd^Fdw, Hhd, Mm, Mm
Mm, Mm, Mm, Mm, Mm, Mm, Mm, Mm, Hhd, Mm, Mm, Mm, Mm, Mm, Mm, Mm, Mm, Mm, Mm, Mm, Mm, Mm, Hhd, Hhd, Gd^Vh, Gd, Re, Gd^Fdf, Hhd, Hhd, Mm, Mm
Mm, Mm, Mm, Mm, Mm, Mm, Mm, Mm, Uu^Vud, Hhd, Mm, Mm, Mm, Mm, Mm, Mm, Mm, Mm, Hhd, Mm, Mm, Mm, Hhd, Hhd, Gd, Gd, Re, Gd, Mm, Mm, Mm, Mm
Mm, Mm, Mm, Mm, Mm, Mm, Mm, Hhd, Mm, Ww, Ww, Mm, Ww, Ww, Ww, Hhd, Hhd, Hhd, Ss, Hhd, Ce, Ce, Ce, Gd, Re, Re, Gd^Vh, Hhd, Mm, Mm, Mm, Mm
Mm, Mm, Mm, Mm, Mm, Mm, Mm, Mm, Mm, Ww, Mm, Ww, Mm, Hhd, Hhd, Ww, Ww, Hhd, Ww, Ww, Ce, 1 Ke, 2 Ce, Re, Ss, Gd, Hhd, Hhd, Mm, Mm, Mm, Mm
Mm, Mm, Mm, Mm, Mm, Mm, Mm, Mm, Mm, Mm, Mm, Mm, Mm, Mm, Hhd, Hhd, Gd^Fdf, Ww, Ww, Ww, Ww, Ww^Bw|, Re, Re, Ss, Ss, Hhd^Fdf, Hhd, Mm, Mm, Mm, Mm
Mm, Mm, Mm, Mm, Mm, Mm, Mm, Mm, Mm, Mm, Mm, Mm, Mm, Mm, Mm, Hhd, Gd^Fdf, Gd^Fdf, Gd^Vh, Ss, Re, Re, Ss, Ss, Hhd^Fdf, Hhd^Fdf, Hhd^Fdf, Mm, Mm, Mm, Mm, Mm
Mm, Mm, Mm, Mm, Mm, Mm, Mm, Mm, Mm, Mm, Mm, Mm, Mm, Mm, Mm, Mm, Hhd, Gd, Re, Re, Hhd, Hhd, Hhd, Hhd, Mm, Mm, Mm, Mm, Mm, Mm, Mm, Mm
Mm, Mm, Mm, Mm, Mm, Mm, Mm, Mm, Mm, Mm, Mm, Mm, Mm, Mm, Gd^Fdf, Hhd, Gd, Gd, Re, Hhd, Hhd, Mm, Mm, Mm, Mm, Mm, Mm, Mm, Mm, Mm, Mm, Mm
Mm, Mm, Mm, Mm, Mm, Mm, Mm, Mm, Mm, Mm, Mm, Mm, Hh, Mm, Gd^Fmf, Gd^Fdf, Gd^Fdf, Gd, Re, Hhd, Hhd, Mm, Mm, Mm, Mm, Mm, Mm, Mm, Mm, Mm, Mm, Mm
Mm, Mm, Mm, Mm, Mm, Mm, Mm, Mm, Mm, Mm, Hh, Hh, Gd, Hh, Gd^Fmf, Gd^Fmf, Gd, Gd, Re, Hhd, Mm, Mm, Mm, Mm, Mm, Mm, Mm, Mm, Mm, Mm, Mm, Mm
Mm, Mm, Mm, Mm, Mm, Mm, Mm, Mm, Hh, Hh, Gd, Gd, Re, Gd, Gd, Gd^Fmf, Re, Re, Hh, Mm, Mm, Mm, Mm, Mm, Mm, Mm, Mm, Mm, Mm, Mm, Mm, Mm
Mm, Mm, Mm, Mm, Mm, Mm, Mm, Hh, Gd, Gs^Vh, Re, Re, Gd, Re, Re, Re, Hh, Hh, Mm, Mm, Mm, Mm, Mm, Mm, Mm, Mm, Mm, Mm, Mm, Mm, Mm, Mm
Mm, Mm, Mm, Mm, Mm, Mm, Mm, Gs^Fdf, Gd^Fmf, Re, Gd, Gd, Hh, Gs^Vh, Hh, Hh, Mm, Mm, Mm, Mm, Mm, Mm, Mm, Mm, Mm, Mm, Mm, Mm, Mm, Mm, Mm, Mm
Mm, Mm, Mm, Mm, Hh^Fdf, Hh^Fdf, Gd^Fdf, Gd^Fmf, Re, Re, Hh, Hh, Mm, Hh, Mm, Mm, Mm, Mm, Mm, Mm, Mm, Mm, Mm, Mm, Mm, Hh, Hh^Fp, Mm, Mm, Mm, Mm, Mm
Mm, Mm, Hh, Hh, Hh^Fdf, Gs^Fmf, Gs^Fmf, Re, Gs^Vh, Gd, Mm, Mm, Mm, Mm, Mm, Mm, Mm, Mm, Mm, Mm, Mm, Mm, Mm, Mm, Mm, Ww, Gs^Vh, Hh^Fp, Mm, Mm, Mm, Mm
Mm, Mm, Hh, Hh, Hh, Gs^Fdf, Re, Re, Gd, Gs, Mm, Mm, Mm, Mm, Mm, Mm, Mm, Mm, Mm, Mm, Mm, Mm, Mm, Mm, Mm, Ww, Ww, Hh, Mm, Mm, Mm, Mm
Mm, Mm, Hh, Hh, Hh, Gs^Vh, Re, Gs, Hh, Hh, Mm, Mm, Mm, Mm, Mm, Mm, Mm, Mm, Mm, Mm, Mm, Mm, Mm, Mm, Hh^Fp, Ww, Mm, Mm, Mm, Mm, Mm, Mm
Mm, Mm, Hh, Hh, Hh, Hh, Re, Re, Hh, Mm, Mm, Mm, Mm, Mm, Mm, Mm, Mm, Mm, Mm, Mm, Mm, Mm, Mm, Mm, Ww, Ww, Mm, Mm, Mm, Mm, Mm, Mm
Mm, Mm, Mm, Hh, Hh, Gs^Vh, Rr, Re, Ch, Mm, Mm, Mm, Mm, Mm, Mm, Mm, Mm, Mm, Mm, Mm, Mm, Mm, Mm, Ww, Ww, Mm, Mm, Mm, Mm, Mm, Mm, Mm
Mm, Mm, Mm, Mm, Hh, Rr, Ch, Rr, Rr, Hh, Gs^Fmf, Hh^Fmf, Gs^Fdf, Hh^Fdf, Hh^Fmf, Mm, Mm, Mm, Mm, Mm, Mm, Mm, Mm, Mm, Hh, Ww, Ww, Mm, Mm, Mm, Mm, Mm
Mm, Mm, Mm, Mm, Mm, Mm, Hh, Gs^Fmf, Gd^Fmw, Rd, Rd, Gs^Fmw, Gd^Fmf, Gs^Fmf, Hh, Hh, Hh, Mm, Mm, Mm, Mm, Mm, Mm, Mm, Mm, Mm, Mm, Ww, Mm, Mm, Mm, Mm
Mm, Mm, Mm, Mm, Mm, Mm, Hh, Hh^Fmf, Gd^Fmf, Gd^Fmf, Gd, Rd, Rd, Gd^Vhr, Gs, Hh, Hh, Hh, Mm, Mm, Mm, Mm, Mm, Mm, Mm, Mm, Mm, Ww, Ww, Mm, Mm, Mm
Mm, Mm, Mm, Mm, Mm, Mm, Mm, Hh^Fmf, Hh, Gd^Fmw, Hh, Gs, Gs, Rd, Gs, Gs, Hh, Hh, Mm, Mm, Mm, Mm, Mm, Mm, Mm, Mm, Mm, Mm, Mm, Ww, Mm, Mm
Mm, Mm, Mm, Mm, Mm, Mm, Mm, Mm, Mm, Hh, Hh, Hh, Gs, Rd, Rd, Gs, Hh, Hh, Mm, Mm, Mm, Mm, Mm, Mm, Mm, Mm, Mm, Mm, Mm, Ww, Mm, Mm
Mm, Mm, Mm, Mm, Mm, Mm, Mm, Mm, Mm, Mm, Mm, Mm, Hh, Gs, Rd, Gs, Hh, Mm, Mm, Mm, Mm, Mm, Mm, Mm, Mm, Mm, Hh, Mm, Ww, Ww, Mm, Mm
Mm, Mm, Mm, Mm, Mm, Mm, Mm, Mm, Mm, Mm, Mm, Hh, Hh^Fmw, Gs^Fmw, Rd, Gs, Hh, Mm, Mm, Mm, Mm, Mm, Mm, Mm, Mm, Mm, Ww, Ww, Gs^Fp, Mm, Mm, Mm
Mm, Mm, Mm, Mm, Mm, Mm, Mm, Mm, Mm, Mm, Mm, Hh, Hh, Gs^Fmf, Rd, Gs, Hh, Mm, Mm, Mm, Mm, Mm, Mm, Mm, Mm, Mm, Ww, Ss, Hh^Fp, Mm, Mm, Mm
Mm, Mm, Mm, Mm, Mm, Mm, Mm, Mm, Mm, Mm, Mm, Hh, Hh, Gs^Fdf, Rd, Gs^Vhr, Gs^Fmf, Hh, Mm, Mm, Mm, Mm, Mm, Mm, Mm, Mm, Hh, Ww, Mm, Mm, Mm, Mm
Mm, Mm, Mm, Mm, Mm, Mm, Mm, Mm, Mm, Mm, Mm, Mm, Hh, Gs, Rd, Gs^Fmw, Hh, Hh, Mm, Mm, Mm, Mm, Mm, Mm, Mm, Mm, Hh, Ww, Mm, Mm, Mm, Mm
Mm, Mm, Mm, Mm, Mm, Mm, Mm, Mm, Mm, Mm, Mm, Mm, Mm, Gs, Rd, Gs, Hh, Hh, Hh, Mm, Hh, Mm, Mm, Mm, Mm, Hh, Ww, Ww, Mm, Mm, Mm, Mm
Mm, Mm, Mm, Mm, Mm, Mm, Mm, Mm, Mm, Mm, Mm, Mm, Mm, Gs^Vhr, Rd, Gs, Gs, Hh, Hh, Mm, Hh, Hh, Hh, Mm, Hh^Fmw, Hh^Fmw, Gs^Vhr, Ww, Hh, Mm, Mm, Mm
Mm, Mm, Hh, Mm, Mm, Mm, Mm, Mm, Mm, Mm, Mm, Mm, Mm, Hh, Hh, Rd, Rd, Gs, Rd, Hh, Gs, Hh, Hh, Hh, Gd, Gs^Fmw, Gs^Fmf, Ww, Hh, Ce, 4 Ke, Gs
Mm, Mm, Hh, Mm, Mm, Mm, Mm, Mm, Mm, Mm, Mm, Mm, Mm, Mm, Mm, Hh, Hh, Rd^Es, Rd, Chr, Rd^Es, Hh, Gs^Vhr, Hh, Gd^Fmw, Gd^Fmf, Gs^Fdf, Ww, Gs, Ce, Ce, Gs
Mm, Mm, Mm, Mm, Mm, Mm, Mm, Mm, Mm, Mm, Mm, Mm, Mm, Mm, Mm, Mm, Hh, Chr, Rd^Es, Rd^Es, Rd, Rd, Gs, Gd, Gd, Gd^Fdf, Gs^Fdf, Ww, Gs, Gs^Fdf, Hh, Hh^Fdf
Hh, Hh, Mm, Mm, Mm, Mm, Mm, Mm, Mm, Mm, Mm, Mm, Mm, Mm, Hh, Mm, Hh, Hh, Gs^Fdf, Gs, Gd^Vhr, Rd, Rd, Gs, Gs^Fdf, Gd, Gs, Ww, Ww, Gs, Hh, Hh^Fdf
Mm, Mm, Mm, Mm, Mm, Mm, Mm, Mm, Mm, Mm, Mm, Mm, Hh, Hh, Ce, Hh, Re, Gs, Gd, Gd, Gd, Gs, Rd, Gs, Gs^Fmf, Gs^Fmf, Gs^Fdf, Gs, Ww^Bw\, Gs, Gs^Fdf, Gs^Fdf
Mm, Mm, Mm, Mm, Mm, Mm, Mm, Mm, Mm, Mm, Mm, Mm, Mm, Ce, 3 Ke, Ce, Gs^Fdf, Gs^Fdf, Gs^Fmf, Gs^Fdf, Gs^Vhr, Gs, Rd, Gs, Gs^Fdf, Gs^Fmf, Gs^Fdf, Ss, Ww, Gd, Gd^Vhr, Gd
Mm, Mm, Mm, Mm, Mm, Mm, Mm, Mm, Mm, Mm, Mm, Mm, Mm, Hh, Gs, Gd, Gs^Fdf, Gs^Fmf, Gs^Fmf, Gs^Fmf, Gs, Gs, Rd, Gs, Gs^Fmf, Gs^Fdf, Gs^Fdf, Ss, Ww, Gs, Gd, Gs
