Gll^Fdf, Gll^Fdf, Gs, Gd^Fdf, Gd^Fdf, Gd^Fdf, Gd^Fdf, Gd^Fdf, Gd^Fdf, Gd^Fdf, Gll^Fp, Gll^Fdf, Gll^Fdf, Gll^Fdf, Gll^Fmf, Gll^Fmf, Gll^Fmf, Gll^Fmf, Gll^Fmf, Gll^Fdf, Gll^Fdf, Gll^Fdf, Ww, Gll^Fdf, Gll^Fdf, Gll^Fdf, Gll^Fdf, Gll^Fdf, Gll^Fdf, Gll^Fdf, Gll^Fdf, Gll^Fdf
Gll^Fdf, Gll^Fdf, Gs, Gd^Fdf, Gd^Fdf, Gd^Fdf, Gll^Fmf, Gd^Fdf, Gd^Fdf, Gd^Fdf, Gll^Fp, Gll^Fp, Gll^Fmf, Gll^Fmf, Ss, Gll^Fmf, Gll^Fp, Gll^Fmf, Gll^Fmf, Gll^Fdf, Ww, Ww, Gll^Fdf, Gll^Fdf, Gll^Fdf, Gll^Fdf, Gd^Fmf, Gll^Fdf, Gll^Fdf, Gll^Fdf, Gll^Fdf, Gll^Fdf
Gll^Fdf, Gll^Fdf, Gs^Vl, Gs, Gs^Vl, Gll^Fp, Gd^Fdf, Gll^Fmf, Gll^Fmf, Gll^Fp, Gll^Fp, Gll^Fp, Gll^Fp, Ss, Gll^Fp, Gll^Fdw, Gs^Fdf, Gll^Fp, Gll^Fmf, Gll^Fmf, Ww, Gll^Fdf, Gll^Fdf, Gll^Fmf, Gll^Fdw, Gd^Fmf, Gd^Fmf, Chr, 3 Khr, Chr, Gll^Fdf, Gll^Fdf
Gll^Fdf, Gll^Fdf, Gll^Fdf, Gs, Gd^Fdf, Gd^Fdf, Gd^Fdf, Gd^Fdf, Gll^Fmf, Gll^Fp, Gll^Fp, Ss, Gll^Fp, Ss, Gs^Vht, Gll, Gll^Fdw, Gs^Fdf, Ss, Gll^Fmf, Ww, Gll^Fdf, Gll^Fdf, Gll^Fdw, Gll^Fdf, Gd^Fmf, Gll^Fdf, Chr, Rd^Edt, Chr, Gd^Fmf, Gll^Fdf
Gll^Fdf, Gll^Fdf, Gll^Fdf, Gs, Gs, Gd^Fdf, Gd^Fdf, Gd^Fdf, Gll^Fmf, Gll^Fdf, Gll^Fmf, Gll^Fmf, Gs^Fdf, Gll^Fp, Ss, Gll^Emf, Gs^Fdf, Gs^Fdf, Ss, Ww, Gll^Fdf, Gll^Fdf, Gs, Gd^Fmf, Gs^Vc, Gd^Fmf, Rd^Edt, Gll^Fdf, Rd^Edt, Gd^Fmf, Gd^Fmf, Gll^Fdf
Gll^Fdf, Gll^Fdf, Gll^Fdf, Gll^Fdf, Ce, Ce, 2 Ce, Gd^Fdf, Gll^Fmf, Gll^Fmf, Gll^Fdw, Gll^Fp, Gs^Fdf, Gll^Em, Ss, Ss, Gs^Fdf, Ss, Ww^Ewl, Ww, Gd, Gs, Gd^Fp, Gd, Gd, Rd, Gd^Fp, Gd, Rd, Gs^Vc, Gd^Fmf, Gll^Fdf
Gll^Fdf, Gll^Fdf, Gll^Fdf, Gll^Fdf, Ce, 1 Ke, Ce, Gd^Fdf, Gd^Fdf, Gll^Fmf, Gll^Fmf, Gll^Fdw, Gs^Fdf, Gs^Fdf, Gll, Gll, Gll, Gll, Gll^Fp, Ww^Bw/, Gd^Fp, Gs^Vc, Gd^Fmf, Gd^Fp, Gs^Fdf, Gll^Fmf, Gd^Fp, Rd, Gll^Fdf, Gll^Fdf, Gd^Fmf, Gd^Fmf
Gll^Fdf, Gll^Fdf, Gll^Fdf, Gll^Fdf, Gll^Fdf, Ce, Gs, Gd^Fdf, Gll^Fdw, Gll^Fmf, Gll^Fmf, Gll^Fp, Gs, Gs, Gll^Fmf, Gd^Fp, Gll^Fmf, Gll^Fp, Ss, Ww, Gd^Fp, Gll^Fdf, Gd^Fmf, Gs^Fdf, Gs^Fdf, Gd^Fp, Gd^Fp, Gs, Gd^Fmf, Gd^Fmf, Gd^Fmf, Gd^Fmf
Gll^Fdf, Gll^Fdf, Gll^Fdf, Gll^Fdf, Gll^Fdf, Gll^Fdf, Gs, Gd^Fdf, Gll^Fmf, Gll^Fmf, Gs^Vc, Gll^Fmf, Gs, Gd^Fp, Gll^Fdf, Gll^Fmf, Ss, Gll^Fp, Ss, Ww, Ww, Ss, Gd^Fmf, Gs^Fdf, Gll^Fp, Gll^Fmf, Gs, Gs, Gs^Fdf, Gd^Fmf, Gll^Fmw, Gd^Fmf
Gll^Fdf, Gll^Fdf, Gll^Fdf, Gll^Fdf, Gll^Fdf, Gll^Fdf, Gll^Fdf, Gs, Gs, Gll^Fdf, Gs, Gs, Gs, Gd^Fp, Gd^Fp, Gll^Fdf, Gll^Fp, Gll^Fmf, Gll^Fp, Gll^Fp, Wo, Gll^Fp, Gll^Fp, Gd^Fmf, Gd, Gd, Gs^Fdf, Gs^Fdf, Gll^Fdw, Gd^Fmf, Gll^Fmw, Gd^Fmf
Gll^Fdf, Gll^Fdf, Gll^Fdf, Gll^Fdf, Gll^Fdf, Gll^Fdf, Gs, Gs, Gd^Fdf, Gd, Gll^Fmf, Gll^Fdf, Gll^Fmf, Gll, Gll, Ss, Ss, Gll^Fdf, Gll^Fp, Gll^Fp, Wo, Ww, Gll^Fp, Gd^Fmf, Gd, Gs^Vc, Gs^Fdf, Gs^Fdf, Gll^Fdw, Gd^Fmf, Gd^Fmf, Gd^Fmf
Gll^Fdf, Gll^Fdf, Gll^Fdf, Gll^Fdf, Gll^Fdf, Gll^Fdf, Gd, Gd^Fdf, Gd^Fdf, Gs, Gll^Fdf, Gll^Fmf, Gll^Fdf, Gll^Fdf, Gll, Gll^Fp, Gll^Fp, Gll^Fp, Gll^Fp, Ww^Ewl, Ww, Gll^Fp, Gll^Fp, Gll^Fp, Gs, Gd, Gs, Gs^Fdf, Gs^Fdf, Gll^Fmw, Gll^Fmw, Gd^Fmf
Gll^Fdf, Gll^Fdf, Gs, Gs, Gll^Fdf, Gs^Vht, Gd, Gd^Fdf, Gll^Fmf, Gll^Fp, Gll^Fp, Gll^Fmf, Gll^Fdf, Ss, Ss^Ewf, Gll, Gll, Gs^Vc, Gll, Gll, Wwf, Gll, Gll, Gs, Gll^Fmw, Gll^Fdf, Gll^Fdf, Gs, Gs^Fdf, Gll^Fmw, Gll^Fmw, Gll^Fmw
Gs, Gll^Fdf, Gs, Gs^Fmf, Gll^Fdf, Gll^Fdf, Gs, Gll^Fmf, Gll^Fmf, Gll^Fp, Gll^Fp, Gll^Emf, Gs^Vht, Gll^Em, Gll^Fmf, Gll^Fmf, Gs, Gll, Gll^Fp, Ss, Ss, Ww, Gll^Fdf, Gll^Fdf, Gll^Fmw, Gll^Fmw, Ss, Gs, Gs, Gs^Fdf, Gll^Fmw, Gll^Fdf
Gll^Fdf, Gs, Gs^Fdw, Gs^Fmf, Gll^Fp, Gll^Fdf, Gs, Gs, Gll^Fmf, Gll^Fdf, Ss, Gll^Fmf, Gll^Fmf, Gll^Fdw, Ss, Gll^Fmf, Gs, Gll^Fp, Gll^Fp, Gll^Fp, Ss, Ww, Wo, Ww, Ss, Gll^Em, Ss, Gd^Fdf, Gd^Fdf, Gs, Gll^Fdf, Gll^Fmw
Gll^Fdf, Gll^Fmf, Gll^Fp, Gll^Fp, Gll^Fdw, Gs, Gd, Gll^Fdf, Gll^Fmf, Gll^Fdw, Ss^Ewl, Gd^Fdf, Gd^Fdf, Gd^Fdf, Ss, Gg^Fet, Gs, Gg^Fet, Ss, Gll^Fp, Gll^Fp, Ss, Sm, Wo, Ss^Ewf, Gll^Fdf, Gll^Fmw, Gll^Fdw, Gd^Fdf, Gs, Gll^Fdf, Gll^Fdf
Gll^Fdf, Gll^Fdf, Gll^Fp, Gd^Fmf, Gd^Fmf, Gd^Fmf, Gll^Fdf, Gd, Gd^Fdf, Gd^Fdf, Gd^Fdf, Gd^Fdf, Gd^Fdf, Gg^Fet, Ss, Chr, 5 Khr, Chr, Ss, Gg^Fet, Gll^Fp, Gll^Fp, Gll^Fp, Wo, Wo, Ss, Sm, Ss, Gd^Fdf, Gs, Gll^Fdf, Gll^Fmf
Gll^Fdf, Gll^Fdf, Gd^Fmf, Gll^Fp, Gd^Fmf, Gd^Fmf, Gs, Gd, Gll, Gll^Em, Gll^Em, Gd^Fdf, Gd^Fdf, Gs, Gg^Fet, Ss, Chr, Ss, Gg^Fet, Gs, Gll^Fmw, Gs, Hh^Fp, Gs, Gs, Ww, Gd, Gd^Fdf, Gs, Gs^Vc, Gll^Fdf, Gll^Fmf
Gll^Fdf, Gll^Fdf, Gd^Fmf, Gd^Fmf, Gll^Fdf, Gs, Gs^Vht, Gd^Fp, Gd^Fp, Ss, Gd^Fdf, Gd^Fdf, Gd^Fdf, Gd^Fdf, Ss, Ss^Ewf, Ss, Ss, Gs, Gll^Fp, Hh^Fmw, Gll^Fp, Hhd^Fp, Hhd^Fp, Gs, Wwf, Ww, Gs, Gll^Fmf, Gll^Fdf, Gll^Fmw, Gll^Fdf
Gll^Fdf, Gll^Fdf, Gd^Fmf, Gd^Fmf, Gs, Gd, Gd^Fp, Gll^Fdf, Gd^Fp, Ss, Gll, Gd^Fdf, Gll, Gs, Gs, Ss, Gg^Fet, Gll^Fp, Hh^Fp, Rd, Hhd, Hh^Fmw, Hhd, Rd, Wwrg, Wwg, Wwg, Gd^Fdf, Gll^Fmw, Gll^Fmw, Gll^Fmw, Gll^Fmf
Gll^Fdf, Gd^Fmf, Gll^Fdf, Gll^Fdf, Gd, Gd^Fp, Gll^Fmf, Gll^Fmf, Ss, Ss, Ss, Gll, Ss, Ss, Gll^Fp, Gll^Fp, Hh^Fp, Gll^Fp, Hh^Fmw, Hh^Fp, Hhd^Fp, Rd, Hhd^Fmw, Hhd^Fmw, Hhd^Fmw, Hhd^Fp, Wwg, Gd^Fdf, Gd^Fdf, Gll^Fmf, Gll^Fmf, Gll^Fdf
Gll^Fdf, Gll^Fdf, Gll^Fdf, Gll^Fdf, Gd, Gd^Fp, Ss, Gd^Fp, Gs, Gs^Em, Ww^Ewl, Gll^Em, Sm, Gll^Fmw, Gll^Fp, Gll^Fmw, Gll^Fmw, Gll^Fmw, Hh, Hh, Hhd, Rd, Exos, Exos, Exos, Hhd, Hhd^Fp, Wwg^Es, Wwg, Gll^Fp, Gll^Fp, Gll^Fmw
Gll^Fdf, Ww, Ww, Ww, Ww^Bw|, Ww, Wo, Gd^Fp, Ww, Wwf, Ww, Ss, Ss, Ss, Ss, Ss, Hh^Fp, Hh^Fp, Hh^Fmw, Hhd^Fmw, Hhd^Fmw, Hhd^Fmw, Exos, Xuf, Exos, Hhd^Fmw, Wwrg, Wo^Es, Wwg, Gll^Fp, Gll^Fp, Gll^Fmw
Ww, Ww, Gd^Fp, Gd^Fp, Gd, Wo, Ss, Ww, Gd^Fp, Gs, Wo, Ww, Wo, Sm, Ss, Hh^Fp, Hh^Fp, Hh^Fp, Hh^Fp, Hh^Fp, Hhd^Fp, Hhd^Fmw, Hhd^Fmw, Exos, Hhd^Fmw, Hhd^Fmw, Hhd^Fp, Wo^Es, Wwg, Gll^Fp, Gll^Fp, Gll^Fp
Gd^Fp, Gd^Fp, Gd^Fp, Gd^Fp, Gd, Gd^Fp, Gd^Fp, Gd^Fp, Gd^Fp, Gd, Gs^Fmf, Wo, Gs^Fmf, Ww, Ww, Ww, Ww, Ww, Wwg^Es, Wwg, Hhd^Fp, Hhd^Fmw, Wwg, Hhd^Fmw, Hhd^Fp, Wwrg, Wo^Es, Wo^Es, Wo, Ww, Ww, Ww
Gd^Fp, Gd^Fp, Gd^Fp, Gs^Vht, Gs, Gd^Fp, Gd^Fp, Gd^Fp, Gd^Fp, Gd, Gd, Gs^Fmf, Gs^Fdf, Gs^Fmf, Gs^Fmf, Gd^Fdf, Gd^Fdf, Gd^Fdf, Wwg^Es, Wwg^Es, Ww^Es, Hhd^Fp, Wo^Es, Hhd^Fp, Wo^Es, Wo^Es, Wo^Es, Wo^Es, Wo, Wo^Es, Wo, Ww
Gd^Fp, Gd^Fp, Gll^Fmf, Gll^Fmf, Gll^Fp, Gs, Gd, Gd, Gs, Gs^Vht, Gd^Fp, Gd, Gs^Fdf, Gs^Fmf, Gd^Fdf, Gd^Fdf, Gd^Fdf, Gd^Fdf, Gd^Fdf, Gll^Fmf, Gll^Fmf, Wo^Es, Wwg, Wo^Es, Wwg, Wwg, Wwg, Wwg, Gll^Fp, Ww, Gll^Fmw, Ww
Gd^Fp, Gd^Fp, Ss, Gll^Fp, Gll^Fp, Gll^Fp, Gll^Fp, Ss, Gll^Fp, Gll^Fmf, Gll^Fmf, Rd, Gs^Fdf, Gs^Vc, Gd^Fdf, Gd^Fdf, Gd^Fdf, Gd^Fdf, Gd^Fdf, Gd^Fdf, Gd^Fdf, Gd^Fdf, Gll^Fmf, Gll^Fdf, Gll^Fdf, Gll^Fdf, Gll^Fmw, Gll^Fdf, Gll^Fp, Gll^Fmw, Gll^Fmw, Gll^Fp
Gd^Fp, Ss, Ss, Ss, Gll^Fmf, Gs, Gs, Ss, Gll^Fmf, Gll^Fmf, Gll^Fp, Rd, Rd^Edt, Rd^Edt, Gd^Edt, Gs, Gd^Fdf, Rd^Edt, Gs, Gd^Fdf, Gd^Fdf, Gll^Fmf, Gll^Fmf, Gll^Fmw, Gll^Fmw, Gll^Fmw, Gll^Fmw, Gll^Fdf, Gll^Fmw, Gll^Fmw, Gll^Fdf, Gll^Fdf
Gd^Fp, Gd^Fp, Gll^Fmf, Gll^Fmf, Gs, Gll^Fmf, Gll^Fmf, Gll^Fmf, Ss, Gll^Fp, Gll^Fmf, Gll^Fp, Gll^Fp, Chr, 4 Khr, Chr, Rd^Edt, Gd^Fdf, Gll^Fmf, Gd^Fdf, Gs, Gs, Gd, Gll^Fmf, Gs, Gs, Gs^Vc, Gll^Fmw, Gll^Fp, Gll^Fp, Gll^Fdf, Gll^Fdf
Gd^Fp, Gll^Fmf, Gd^Fp, Ss, Ss, Gd^Fp, Gll^Fmf, Gll^Fmf, Gll^Fp, Gll^Fmf, Gll^Fmf, Gll^Fmf, Gll^Fmf, Chr, Gll^Fp, Chr, Rd^Edt, Gs^Vht, Gll^Fmf, Gd^Fdf, Gll^Fmf, Gll^Fdf, Gll^Fdf, Gd, Gll^Fdf, Gll^Fdf, Gll^Fp, Gs, Gll^Fp, Gll^Fdf, Gll^Fp, Gll^Fp
Gd^Fp, Gd^Fp, Gd^Fp, Ss, Gd^Fp, Ss, Gll^Fp, Gll^Fp, Rd, Ss, Gll^Fp, Gll^Fmf, Gd^Fp, Gll^Fmf, Gll^Fp, Gll^Fp, Gll^Fp, Gs, Gll^Fmf, Gll^Fmf, Gll^Fmf, Gll^Fmf, Gd^Fp, Gll^Fdf, Gd^Fp, Gd^Fp, Gll^Fdf, Gs, Gll^Fdf, Gll^Fp, Gll^Fdf, Gll^Fp
