Xu, Xu, Xu, Xu, Xu, Xu, Xu, Xu, Xu, Xu, Xu, Xu, Xu, Xu, Xu, Xu, Xu, Xu, Xu, Xu, Qxu, Xu, Qxu, Xu, Xu, Xu, Xu
Xu, Xu, Xu, Xu, Xu, Xu, Xu, Xu, Xu, Xu, Xu, Xu, Uu^Es, Uu, Uu^Es, Xu, Uu^Edb, Xu, Xu, Qxu, Exos^Qhux, Qxu, Exos^Qhux, Qxu, Qxu, Xu, Xu
Xu, Xu, Xu, Xu, Xu, Xu, Xu, Xu, Uu^Edb, Uu^Edb, Uu^Vu, Uu^Es, Uu^Es, Uu^Es, Uu^Es, Uu, Uu^Vu, Uu^Edb, Uu^Edb, Exos^Qhux, Exos^Qhux, Exos^Qhux, Exos^Qhux, Exos^Qhux, Qxu, Xu, Xu
Xu, Xu, Xu, Xu, Qxu, Xu, Uu^Edb, Uu^Edb, Exos^Qhux, Uu^Edb, Uu^Edb, Uu^Edb, Cfr^Edb, Cfr^Edb, Cfr^Edb, Uu^Edb, Uu, Uu^Em, Exos^Qhux, Uu^Edb, Uu^Edb, Exos^Qhux, Exos^Qhux, Exos^Qhux, Qxu, Xu, Xu
Xu, Xu, Xu, Qxu, Exos^Qhux, Qxu, Uh, Uu^Edb, Uu^Edb, Exos^Qhux, Uu^Edb, Uu^Edb, Cfr^Edb, 3 Kfr, Cfr^Edb, Uu, Uu^Em, Uu^Tf, Exos^Qhux, Uu^Edb, Uu^Es, Exos^Qhux, Qxu, Qxu, Xu, Xu, Xu
Xu, Xu, Qxu, Qxu, Exos^Qhux, Exos^Qhux, Uh, Uh, Uu^Edb, Exos^Qhux, Uu^Vu, Uu^Edb, Uu^Edb, Cfr^Edb, Uu, Uu, Uu^Vu, Exos^Qhux, Uu^Edb, Uu^Es, Uu^Es, Xu, Xu, Xu, Xu, Xu, Xu
Xu, Qxu, Exos^Qhux, Exos^Qhux, Exos^Qhux, Exos^Qhux, Uh, Uh, Uu^Es, Uu^Es, Uu, Uu, Uu^Edb, Uu^Es, Uu^Edb, Uu, Uh, Uh, Uu^Edb, Uu^Es, Uu^Es, Xu, Xu, Xu, Xu, Xu, Xu
Xu, Qxu, Qxu, Exos^Qhux, Exos^Qhux, Exos^Qhux, Exos^Qhux, Exos^Qhux, Uu^Tf, Uu^Em, Uu, Exos^Qhux, Exos^Qhux, Exos^Qhux, Exos^Qhux, Exos^Qhux, Uu^Edb, Uu^Edb, Uu^Em, Xu, Xu, Xu, Xu, Xu, Xu, Xu, Xu
Xu, Xu, Xu, Qxu, Qxu, Qxu, Qxu, Uh, Uu^Edb, Uu^Em, Uu^Edb, Uu^Edb, Uu^Edb, Uu, Uu, Uu^Edb, Uh, Uh, Uu^Em, Uu^Tf, Xu, Xu, Xu, Xu, Xu, Xu, Xu
Xu, Xu, Xu, Xu, Xu, Xu, Xu, Uh, Uu, Exos^Qhux, Uu^Edb, Uh, Uh, Uu, Uu, Uu^Edb, Exos^Qhux, Exos^Qhux, Uu^Edb, Uh, Xu, Xu, Xu, Xu, Xu, Xu, Xu
Xu, Xu, Xu, Xu, Uu^Em, Xu, Uu^Tf, Uu^Edb, Uu, Uu^Edb, Exos^Qhux, Exos^Qhux, Uh, Uu^Edb, Xu, Uu^Edb, Uu^Vu, Exos^Qhux, Uh, Uh, Uu, Xu, Xu, Xu, Xu, Xu, Xu
Xu, Xu, Xu, Xu, Uu^Em, Uu^Em, Xu, Xu, Uu^Vu, Uu^Edb, Exos^Qhux, Uh, Uh, Uu^Edb, Xu, Uh, Uu, Uu, Uu^Tf, Xu, Xu, Uu, Xu, Xu, Xu, Xu, Xu
Xu, Xu, Xu, Uu, Xu, Xu, Xu, Xu, Xu, Uu^Edb, Uu^Edb, Uu^Edb, Xu, Xu, Xu, Xu, Uu, Uu, Xu, Xu, Xu, Re, Xu, Xu, Xu, Xu, Xu
Xu, Xu, Xu, Re, Uu, Xu, Xu, Xu, Xu, Uu^Tf, Uu^Edb, Uu^Edb, Xu, Xu, Xu, Xu, Uu^Es, Uu, Xu, Xu, Xu, Uu^Em, Uu^Em, Xu, Xu, Xu, Xu
Xu, Xu, Xu, Xu, Uu, Xu, Uh, Xu, Uu^Edb, Uu^Edb, Re, Uu^Edb, Re, Uu, Re^Tf, Re, Re^Es, Uu^Es, Uu, Xu, Xu, Xu, Uh^Tf, Xu, Xu, Xu, Xu
Xu, Xu, Xu, Xu, Xu, Uu^Tf, Uu^Es, Uu^Tf, Uu^Tf, Re, Wwg^Qhu, Sm^Qhu, Sm^Qhu, Re^Tf, Wwg^Qhu, Sm^Qhu, Sm^Qhu, Uu, Uu, Uu, Uu, Uu^Em, Uu^Em, Xu, Xu, Xu, Xu
Xu, Xu, Wog, Wog, Wog, Uu, Wwg, Wwg^Qhu, Wwg^Qhu, Wwg^Qhu, Wog^Qhu, Wog^Qhux, Wo^Qhu, Sm^Qhu, Wo^Qhu, Wog^Qhux, Wog^Qhu, Sm^Qhu, Wwg^Qhu, Wwg^Qhu, Wwg, Uu^Em, Wog, Xu, Wog, Xu, Xu
Xu, Xu, Xu, Xu, Re, Wwg, Uu^Tf, Uu^Em, Tb^Tf, Sm^Qhu, Wwg^Qhu, Wog^Qhux, Sm^Qhu, Wog^Qhu, Sm^Qhu, Wog^Qhux, Wwg^Qhu, Sm^Qhu, Uu^Tf, Uu, Uu, Wwg, Uu, Wog, Xu, Xu, Xu
Xu, Xu, Xu, Xu, Re, Re, Uu^Vu, Uu^Em, Uu^Emf, Uu^Tf, Tb^Tf, Sm^Qhu, Tb^Tf, Sm^Qhu, Tb^Tf, Wwg^Qhu, Tb^Tf, Uu^Tf, Re^Em, Re^Es, Uu^Vu, Uu, Uu, Xu, Xu, Xu, Xu
Xu, Xu, Xu, Xu, Xu, Uu, Uu, Uu^Tf, Tb^Tf, Uu^Em, Xu, Tb^Tf, Xu, Uu^Tfi, Xu, Tb^Tf, Xu, Uu^Em, Re^Em, Re, Uu^Tf, Uu^Tf, Xu, Xu, Xu, Xu, Xu
Xu, Xu, Xu, Xu, Xu, Xu, Xu, Xu, Uu^Tf, Re^Em, Uu, Xu, Xu, Xu, Xu, Xu, Uh, Uu, Uu, Xu, Xu, Xu, Xu, Xu, Xu, Xu, Xu
Xu, Xu, Xu, Xu, Xu, Xu, Xu, Uu, Xu, Re^Em, Uu, Uu, Uu, Uu^Vu, Uu, Uh, Uu, Uu, Xu, Uh, Xu, Xu, Xu, Xu, Xu, Xu, Xu
Xu, Xu, Xu, Xu, Xu, Xu, Xu, Uu, Uu, Uu, Uu, Uu, Cud, Uu^Ii, Cud, Uu, Uu, Uu, Uh, Uh, Xu, Xu, Xu, Xu, Xu, Xu, Xu
Xu, Xu, Xu, Xu, Xu, Xu, Xu, Xu, Xu, Uu^Vu, Uh, Uu, Cud, 1 Kud, 2 Cud, Re, Uu, Uu^Vu, Xu, Xu, Xu, Xu, Xu, Xu, Xu, Xu, Xu
Xu, Xu, Xu, Xu, Xu, Xu, Xu, Xu, Xu, Xu, Uh, Uh, Uh, Cud, Uu, Uh, Uh, Xu, Xu, Xu, Xu, Xu, Xu, Xu, Xu, Xu, Xu
Xu, Xu, Xu, Xu, Xu, Xu, Xu, Xu, Xu, Xu, Xu, Xu, Xu, Uh, Xu, Xu, Xu, Xu, Xu, Xu, Xu, Xu, Xu, Xu, Xu, Xu, Xu
Xu, Xu, Xu, Xu, Xu, Xu, Xu, Xu, Xu, Xu, Xu, Xu, Xu, Uh, Xu, Xu, Xu, Xu, Xu, Xu, Xu, Xu, Xu, Xu, Xu, Xu, Xu
