Wo, Wo, Wo, Ww, Ww, Ww, Aa, Aa, Aa, Aa^Fda, Aa, Aa, Aa, Re, Aa, Ha, Ha, Ha^Fda, Ha^Fda, Aa^Fda, Ha^Fda, Aa^Fda, Aa, Aa, Aa, Aa, Aa, Aa, Aa, Aa, Aa, Aa, Aa, Aa, Aa
Wo, Wo, Wo, Ww, Ww, Ww, Aa, Aa, Aa, Aa^Fda, Aa, Aa, Aa, Re, Aa, Ha, Ha, Ha^Fda, Ha, Ha^Fda, Aa^Fda, Aa^Fda, Aa, Aa, Aa, Aa, Aa, Aa, Aa^Vha, Aa, Aa, Aa, Aa, Aa, Aa
Wo, Wo, Wo, Ww, Ww, Ww, Ai, Aa, Aa, Aa, Aa, Aa, Re, Re, Re, Aa, Aa, Ha, Aa, Ha, Ha^Fda, Aa^Fda, Aa^Fda, Aa, Aa, Aa, Aa, Aa, Aa, Aa, Aa, Aa, Aa^Fda, Aa, Aa
Wo, Wo, Ww, Ww, Ww, Ww, Ww, Aa, Aa, Aa, Aa, Aa, Aa^Fda, Aa^Vla, Aa, Re, Re, Aa, Aa, Ha, Ha^Fda, Ha^Fda, Aa^Fda, Aa, Aa, Aa, Aa, Aa, Aa, Aa, Aa^Fda, Aa^Fda, Aa^Fda, Aa^Fda, Aa^Fda
Wo, Wo, Ww, Ha, Ha, Ww, Ww, Ai, Aa, Aa, Aa, Aa, Re, Aa, Aa^Fda, Aa^Fda, Aa^Fda, Re, Aa, Ha, Ha, Aa^Fda, Aa, Aa, Aa, Aa, Aa, Aa, Ai, Ai, Ww, Ai, Ww, Ww, Ww
Wo, Wo, Ww, Aa, Ww, Ww, Ww, Ww, Ww, Aa, Aa, Aa^Vla, Aa, Re, Re, Aa^Fda, Aa^Vha, Re, Re, Aa, Aa^Vha, Aa, Aa, Aa, Aa, Aa, Ww, Ww, Ww, Ww, Wo, Ww, Wo, Wo, Wo
Wo, Wo, Wo, Ww, Wo, Ww, Ww, Ww, Ww, Ai, Aa, Aa, Re, Re, Aa, Re, Re, Re, Aa, Re, Re, Cha, Ai, Ai, Ww, Ww, Wo, Wo, Wo, Wo, Wo, Wo, Wo, Wo, Wo
Wo, Wo, Wo, Wo, Ww, Ww, Ww, Wo, Wo, Ww, Ww, Aa, Aa, Aa^Vha, Aa, Aa, Aa, Aa^Fda, Aa, Cha, Ww, Ww^Bsb\, Ww^Bsb\, Ai, Ww, Wo, Wo, Wo, Wo, Wo, Wo, Wo, Ww, Wo, Wo
Wo, Wo, Wo, Ww, Ww, Ww, Ww, Wo, Wo, Wo, Wo, Ww, Ww, Aa, Aa, Aa^Fda, Aa^Fda, Aa^Fda, Ww, Ww, Wo, Ww, Ww, Ww^Bsb\, Ww^Bsb\, Ww, Ww, Ww, Ww, Ww, Ww, Ww, Ai, Ww, Ww
Wo, Wo, Wo, Ww, Aa^Fda, Aa, Aa^Vha, Ww, Ww, Wo, Ww, Wo, Wo, Ww, Ww, Aa^Fda, Ww, Ww, Wo, Wo, Ww, Ww, Ww, Ww, Ai, Ww^Bsb\, Rr, Cha, Cha, Ai, Aa, Aa, Aa, Aa, Aa
Wo, Wo, Wo, Ww, Ha^Fda, Ha^Fda, Aa, Ai, Aa, Ww, Ww, Ww, Ww, Ww, Ww, Ww, Ww, Wo, Ww, Wo, Ww, Ww^Bw\, Aa, Aa^Vhca, Aa^Fda, Cha, Aa, Rr, Rr, Aa, Aa, Aa, Aa, Aa, Aa
Wo, Wo, Wo, Ww, Aa^Vha, Ha^Fda, Aa^Fda, Aa^Vhca, Aa, Aa^Vhca, Aa, Ai, Ai, Ai, Ai, Ww, Ww, Ww, Ww^Bw\, Ww, Ai, Aa, Cha, Aa, Aa, Aa, Rr, Rr, Cha, Re, Re, Aa, Aa, Aa, Aa
Wo, Wo, Ww, Ww, Aa, Ha, Aa^Fda, Rr, Rr, Aa, Aa, Aa, Aa, Ai, Aa, Ai, Ai, Ww, Aa, Aa, Cha, Ai, 3 Kha, Cha, Rr, Rr, Aa, Aa, Aa, Aa, Aa, Re, Re, Aa, Aa
Wo, Wo, Wo, Ww, Ww, Aa, Ai, Aa, Aa, Rr, Rr, Aa, Rr, Rr, Rr, Aa, Aa, Aa, Aa, Aa, Aa, Cha, Rr, Rr, Aa^Fda, Aa^Vhca, Aa, Cha, Aa, Aa, Aa, Aa, Aa, Re, Re
Wo, Wo, Wo, Ww, Ww, Ww, Ww, Ai, Ai, Aa, Aa^Vhca, Rr, Cha, 2 Rr, Cha, Rr, Aa^Fda, Aa^Fda, Aa^Fda, Aa^Vhca, Rr, Rr, Aa, Aa^Fda, Aa^Vhca, Aa^Fda, Cha, Aa, Aa, Aa, Aa^Fda, Aa^Fda, Aa^Fda, Aa, Aa
Wo, Wo, Wo, Wo, Ww, Ww, Wo, Ww, Ww, Ai, Ai, Aa, Cha, 1 Kha, Cha, Rr, Rr, Aa^Fda, Rr, Rr, Aa^Fda, Aa, Cha, Aa, Cha, Aa, Aa, Aa, Aa, Aa, Aa^Fda, Aa^Fda, Aa^Fma, Aa, Aa
Wo, Wo, Wo, Wo, Wo, Wo, Wo, Wo, Ww, Ww, Ww, Aa, Aa, Cha, Aa, Aa, Aa^Vhca, Rr, Ha, Aa^Vhca, Aa^Fda, Aa, Aa, Aa, Aa, Aa, Aa, Aa, Aa, Aa, Aa, Aa^Fma, Ha, Aa^Fma, Aa^Fma
Wo, Wo, Wo, Wo, Wo, Wo, Wo, Wo, Ww, Ww, Ww, Ww, Ww, Aa, Ha, Ha, Aa, Rr, Aa, Aa^Fda, Aa, Cha, Aa, Aa, Ha, Ha, Ha, Aa, Aa^Fda, Aa^Fda, Aa^Fma, Ha, Ha, Ha, Ha
Wo, Wo, Wo, Wo, Wo, Wo, Wo, Wo, Ww, Ww, Ww, Ww, Ww, Ai, Aa^Vhca, Ha^Fda, Ha^Fda, Rr, Rr, Cha, Aa, Aa, Aa, Ha, Aa, Ha, Ha, Ha, Aa^Fma, Aa^Fma, Aa^Fpa, Aa^Fpa, Ha, Ha, Ha
Wo, Wo, Wo, Wo, Wo, Wo, Wo, Wo, Wo, Ww, Ww, Ww, Ww, Ww, Ai, Aa^Fda, Aa^Fda, Aa^Vhca, Aa^Fda, Rr, Re, Aa, Re, Aa, Aa, Ha, Ha, Ha, Ha, Ha, Ha, Aa^Fpa, Ha, Ha, Ha
Wo, Wo, Wo, Wo, Ww, Wo, Wo, Wo, Ww, Ww, Ww, Ww, Ww, Ww, Ww, Ai, Aa, Aa, Ai, Cha, Aa, Re, Aa, Re, Re, Aa, Aa, Aa, Aa, Ha, Ha, Ha, Ha, Ms, Ms
Wo, Wo, Wo, Wo, Ww, Ww, Ww, Ww, Ww, Ww, Wo, Wo, Wo, Ww, Ww, Ww, Ww, Ai, Ai, Ai, Ai, Aa, Aa, Aa, Aa, Re, Re, Aa, Aa, Aa, Ha, Ha, Ha, Ms, Ms
Wo, Wo, Wo, Wo, Ww, Ww, Ww, Ww, Ww, Ww, Wo, Wo, Wo, Ww, Ww, Ww, Ww, Ai, Ai, Ai, Ai, Aa, Aa, Aa, Aa, Re, Re, Aa, Aa, Aa, Ha, Ha, Ha, Ms, Ms
