Wo, Wo, Wo, Ww, Ww, Ww, Gg, Gs^Fds, Gs^Fds, Gs^Fds, Gg, Gg, Gg, Gg, Gs^Fds, Gs^Fds, Gs^Fds, Re, Gg, Gg, Gg, Gg, Gg, Gs, Gs, Gs, Re, Re, Re, Re, Re, Gg, Gs^Fp, Hh^Fp, Hh, Hh, Hh, Hh, Mm, Hh, Mm, Mm, Mm, Mm, Hh, Hh, Hh
Wo, Wo, Wo, Ww, Ww, Ww, Gg, Gs^Fds, Gs^Fds, Gs^Fds, Gg, Gg, Gs^Fds, Gg, Gs^Fds, Gs^Fds, Gs^Fds, Re, Gg, Gg, Ss, Gg, Ss, Gs, Ss, Gs, Re, Re, Ce, Ce, Ce, Gg, Gs^Fp, Hh^Fp, Hh^Fp, Hh, Hh, Hh, Mm, Hh, Mm, Mm, Mm, Mm, Hh, Hh, Hh^Fp
Wo, Wo, Wo, Wo, Ww, Ww, Gs^Fds, Gs^Fds, Gg, Gs^Fds, Gs^Fds, Gs^Fds, Gg, Gg, Gs^Fds, Gs^Fds, Gs^Fds, Re, Ss, Ss, Ss, Ss, Ss, Ss, Gg, Gs, Re, Re, Ce, 4 Ke, Ce, Gg^Vh, Gs^Fms, Gs^Fms, Gs^Fms, Hh, Mm, Mm, Mm, Mm, Mm, Mm, Mm, Mm, Mm, Hh^Fp, Hh^Fp
Wo, Wo, Wo, Wo, Ww, Ww, Ds, Gs^Fds, Gs^Fds, Gs^Fds, Gg, Gg, Gg, Gs^Fds, Ss, Ss, Gs^Fds, Re, Hh, Gg^Vh, Hh, Ss, Hh, Gg, Gg, Re, Re, Re, Re, Ce, Re, Re, Gg, Gg, Gs^Fms, Hh^Fp, Hh, Mm, Mm, Mm, Mm, Mm, Mm, Mm, Mm, Gs^Fp, Gs^Fp
Wo, Wo, Wo, Ww, Ww, Ww, Ds, Gg, Gs^Fds, Gg, Gg, Gg, Rb^Gvs, Gg, Gg, Gs^Fds, Gg, Re, Hh, Hh, Hh, Hh, Gg, Gg, Gg, Gg, Gg, Gg, Gg^Vh, Re, Hh, Hh, Hh, Re, Gg, Hh^Fp, Mm, Mm, Mm, Hh^Vhh, Mm, Mm, Hh, Mm, Hh, Mm, Mm
Wo, Wo, Wo, Ww, Ww, Ww, Ds, Gg, Gs^Vl, Gg, Rb^Gvs, Rb^Gvs, Rb^Gvs, Rb^Gvs, Gg, Gg, Rb^Gvs, Re, Re, Hh, Hh, Hh, Gg, Gg^Vh, Gg, Gg, Hh, Hh, Gs^Fms, Hh, Mm, Mm, Hh, Re, Gg, Hh, Hh, Hh, Mm, Mm, Hh, Hh, Gg, Hh, Hh, Hh, Hh
Wo, Wo, Wo, Ww, Ww, Ww^Bw\, Ds, Gg, Gg, Rb^Gvs, Rb^Gvs, Rb^Gvs, Gg, Gg, Rb^Gvs, Rb^Gvs, Rb^Gvs, Rb^Gvs, Gs^Vl, Re, Re, Hh, Gg, Gs^Fds, Gs^Fds, Gg, Hh^Fds, Mm, Mm, Hh, Mm, Mm, Mm, Hh, Hh, Re, Gg, Hh, Hh, Hh, Hh, Gg, Gg, Gg, Gg, Gg, Gg
Wo, Wo, Ww, Ww, Ww, Ww, Ds, Gg, Gg, Gg, Gg, Gg, Gg, Gg, Gs^Fds, Rb^Gvs, Gg, Gg, Gs^Fds, Gs^Fds, Gs^Fds, Re, Hh, Gs^Fds, Hh^Fds, Gs^Fds, Hh^Fds, Mm, Mm, Mm, Mm, Mm, Mm, Mm, Hh, Gg^Vh, Hh, Gg, Gg, Gg, Gg, Gg, Gg, Gg, Gg, Gg, Gg
Wo, Wo, Ww, Ww, Ww, Ds, Ds, Gg, Gg, Gg, Rb^Gvs, Rb^Gvs, Gg, Gs^Fds, Gs^Fds, Gs^Fds, Hh^Fds, Gs^Fds, Gs^Fds, Gs^Fds, Gs^Fds, Re, Hh, Hh, Hh, Hh^Fds, Mm, Mm, Mm, Mm, Hh, Mm, Mm, Mm, Hh, Hh, Hh, Gg, Gg, Gg, Gg, Gg, Gg, Gg, Re, Re, Re
Wo, Wo, Wo, Ww, Ww, Ds, Ds, Gg, Rb^Gvs, Rb^Gvs, Gs^Fds, Rb^Gvs, Gg, Gg, Hh^Fds, Hh^Fds, Gs^Fds, Gs^Fds, Gs^Fds, Gs^Fds, Re, Re, Gg, Hh, Hh, Hh, Mm, Mm, Mm, Mm, Hh, Hh, Hh^Fp, Hh, Gg, Hh, Gg, Hh, Gg^Vh, Gg, Re, Gg, Re, Re, Gg, Gg, Gg
Wo, Wo, Wo, Wo, Wo, Ww, Gg, Gg, Rb^Gvs, Rb^Gvs, Rb^Gvs, Rb^Gvs, Gg, Gs^Vl, Hh, Hh^Fds, Gg, Gg, Gg, Re, Gg^Vh, Gg, Gg, Gg, Hh, Hh, Mm, Mm, Mm, Hh, Hh, Gg, Gs^Fms, Gg, Gg^Vh, Gg, Gs^Fms, Gg, Re, Re, Gs^Fds, Re, Gg^Vh, Gg, Gg, Gg, Gg
Wo, Wo, Wo, Wo, Ww, Ww, Ww, Gg, Gg, Rb^Gvs, Rb^Gvs, Rb^Gvs, Gg, Hh, Hh, Gg, Re, Gg, Re, Re, Gg, Gg, Gg, Gg, Hh, Hh, Hh^Fds, Hh, Hh^Fds, Hh, Gg, Gg, Gs^Fds, Gs^Fds, Gs^Fds, Gs^Fds, Re, Re, Gg, Gg, Gg, Gg, Gg, Gg, Ww, Ww, Ww
Wo, Wo, Wo, Wo, Ww, Ww, Ww, Ds, Gg, Gg, Gg, Gg, Gg, Gg, Re, Re, Hh, Re, Gs^Fds, Re, Re, Gg, Gg, Hh, Gg, Gs^Fds, Gs^Fds, Hh^Fds, Hh^Fds, Gs^Fds, Gg, Gg, Gg, Gs^Fms, Re, Re, Gs^Fds, Gs^Fms, Gg, Gg, Ww, Ww, Ww, Ww, Wo, Wo, Wo
Wo, Wo, Wo, Wo, Ww, Ww, Ww, Ds, Gs^Fds, Gs^Fds, Gg, Gg, Gg, Re, Gg, Hh, Hh, Hh^Fds, Hh^Fds, Gs^Fds, Hh^Fds, Re, Re, Gg, Gg, Gg, Gs^Fds, Gs^Fds, Gs^Fds, Gs^Fds, Gg, Gg, Gg, Re, Gg^Vh, Gs^Fds, Gs^Fds, Gg, Ww, Ww, Wo, Wo, Wo, Wo, Wo, Wo, Wo
Wo, Wo, Wo, Ww, Ww, Ww, Gg, Gg, Gg, Gs^Fds, Gg, Gg, Gg, Re, Gg, Hh, Hh, Hh^Fds, Hh, Hh^Fds, Gs^Fds, Gs^Fds, Gg, Re, Re, Gg, Gg, Gg, Gg^Vh, Gg, Re, Re, Re, Re, Re, Gg, Gg, Gg, Ww, Ww, Wo, Wo, Wo, Wo, Wo, Wo, Wo
Wo, Wo, Wo, Ww, Ww, Ww, Ww, Gg, Gg, Gg, Rb^Gvs, Rb^Gvs, Rb^Gvs, Re, Re, Gg, Gg, Hh, Gg, Hh, Hh^Fds, Gs^Fds, Gs^Fds, Gg, Gg, Re, Re, Re, Re, Re, Gg, Gg, Gs^Fds, Gg, Gs^Fds, Gg, Wwf, Wwf, Ww, Wo, Wo, Wo, Ww, Wo, Ww, Ww, Ww
Wo, Wo, Ww, Ww, Ww, Ww, Ww, Gg, Gg, Rb^Gvs, Rb^Gvs, Rb^Gvs, Gs^Fds, Gs^Vl, Gg, Re, Re, Gg, Gg, Hh, Hh^Fds, Hh^Fds, Gs^Fds, Gg, Gg, Gg, Gg, Gg, Gg, Gg, Gs^Fds, Gs^Fms, Gs^Fds, Gs^Fms, Ww, Ww, Ww, Wwf, Wwf, Ww, Ww, Wo, Ww, Ww, Gg, Gg, Gg
Wo, Wo, Ww, Hh, Hh, Ww, Ww, Ww, Gg, Gg, Gg, Gg, Re, Gg, Gs^Fds, Gs^Fds, Gs^Fds, Re, Gg, Hh, Hh, Gs^Fds, Gg, Gg, Gg, Gg, Gg, Gg, Ww, Ww, Ww, Ww, Ww, Ww, Wo, Wo, Wo, Ww, Wwf, Wwf, Wwf, Ww, Gg, Gg, Gg, Gs^Fds, Gs^Fds
Wo, Wo, Ww, Gg, Ww, Ww, Ww, Ww, Ww, Gg, Gg, Gs^Vl, Gg, Re, Re, Gs^Fds, Gg^Vh, Re, Re, Gg, Gg^Vh, Gg, Gg, Gg, Gg, Gg, Ww, Ww, Ww, Ww, Wo, Ww, Ww, Wo, Wo, Wo, Wo, Ww, Wwf, Wwf, Gg, Gg, Gg, Gg^Vh, Gg, Gs^Fds, Gs^Fds
Wo, Wo, Wo, Ww, Wo, Ww, Ww, Ww, Ww, Ww, Gg, Gg, Re, Re, Gg, Re, Re, Re, Gg, Rr, Rr, Ch, Ww, Ww, Ww, Ww, Wo, Wo, Wo, Wo, Wo, Wo, Ww, Wo, Wo, Wo, Ww, Ww, Gs^Fds, Gg, Gs, Gg, Gg, Gg, Gg, Gg, Gg
Wo, Wo, Wo, Wo, Ww, Ww, Ww, Wo, Wo, Ww, Ww, Ds, Ds, Gg^Vh, Gg, Gg, Gg, Gs^Fds, Gg, Ch, Ww, Ww^Bsb\, Ww^Bsb\, Ww, Ww, Wo, Wo, Wo, Wo, Wo, Wo, Wo, Ww, Ww, Ww, Ww, Ss, Gs^Fds, Gs^Fds, Gs^Fds, Gs, Gg, Gg, Gg, Gg, Gg, Gg
Wo, Wo, Wo, Ww, Ww, Ww, Ww, Wo, Wo, Wo, Wo, Ww, Ww, Ds, Ds, Gs^Fds, Gs^Fds, Gs^Fds, Ww, Ww, Wo, Ww, Ww, Ww^Bsb\, Ww^Bsb\, Ww, Ww, Ww, Ww, Ww, Ww, Ww, Ss, Ww, Ss, Ss, Ss, Gs^Fds, Gs, Gs, Gs, Gs, Gg, Gg, Gg, Gg, Gg
Wo, Wo, Wo, Ww, Gs^Fds, Gg, Gg^Vh, Ww, Ww, Ww, Ww, Wo, Wo, Ww, Ww, Gs^Fds, Ww, Ww, Wo, Wo, Ww, Ww, Ww, Ww, Ww, Ww^Bsb\, Rr, Ch, Ch, Ww, Gg, Gs, Gs^Fds, Gs^Fds, Gs, Gs, Gg^Vh, Ss, Ss, Ss, Ss, Gs, Gs, Gs, Gg, Gs, Gs
Wo, Wo, Wo, Ww, Hh^Fds, Hh^Fds, Gg, Ww, Gg, Ww, Ww, Wo, Wo, Ww, Ww, Ww, Wo, Wo, Ww, Wo, Ww, Ww^Bw\, Ds, Re^Vhc, Gs^Fds, Ch, Gg, Rr, Rr, Gg, Gg, Gg, Gs, Gs^Fds, Gs, Gs, Ss, Ss, Ss, Ss, Ss, Gs, Gs, Gg, Gs, Gs^Fds, Gs^Fds
Wo, Wo, Wo, Ww, Gg^Vh, Hh^Fds, Gs^Fds, Rr^Vhc, Re, Re^Vhc, Ds, Ww, Ww, Ww, Ww, Wo, Wo, Ww, Ww^Bw\, Ww, Ww, Ds, Ch, Re, Re, Gg, Rr, Rr, Ch, Rd, Rd, Gg, Gg, Gs, Gg, Gs, Gs, Ss, Ss, Ss, Ss, Ss, Gs, Gs, Gs^Fds, Gs^Fds, Gs^Fds
Wo, Wo, Ww, Ww, Ds, Hh, Gs^Fds, Rr, Rr, Gg, Gg, Ds, Ds, Ww, Ds, Ww, Ww, Ww, Ds, Ds, Ch, Ww^Do, 3 Kh, Ch, Rr, Rr, Re, Re, Gg, Gg, Gg, Rd, Rd, Gg, Gg, Gs, Ss, Ss, Ss, Ss, Ss, Ss, Ss, Gs, Ss, Gs^Fds, Gs^Fds
Wo, Wo, Wo, Ww, Ww, Gg^Vh, Ww, Ds, Ds, Rr, Rr, Gg, Rr, Rr, Rr, Ds, Ds, Ds, Gg, Gg, Gg, Ch, Rr, Rr, Gs^Fds, Gs^Vhc, Re, Ch, Gg, Gg, Gg, Gg, Gg, Rd, Rd, Gg^Vh, Gs, Gs, Gs, Gs, Gs, Ss, Ss, Ss, Ss, Ss, Ss
Wo, Wo, Wo, Ww, Ww, Ww, Ww, Ww, Ww, Ds, Re^Vhc, Rr, Ch, 2 Rr, Ch, Rr, Gs^Fds, Gs^Fds, Gs^Fds, Gs^Vhc, Rr, Rr, Re, Gs^Fds, Gs^Vhc, Gs^Fds, Ch, Gg, Gg, Gg, Gs^Fds, Gs^Fds, Gs^Fds, Gg, Gg, Rd, Rd, Rd, Rd, Gs^Fds, Gs^Fds, Gs, Gs^Fds, Gs, Gs, Gs, Gs
Wo, Wo, Wo, Wo, Ww, Ww, Wo, Ww, Ww, Ww, Ww, Re, Ch, 1 Kh, Ch, Rr, Rr, Gs^Fds, Rr, Rr, Gs^Fds, Gg, Ch, Re, Ch, Gg, Gg, Gg, Gg, Gg, Gs^Fds, Gs^Fds, Gs^Fms, Gg, Gg^Vh, Gg, Gg, Gg, Gg^Vh, Rd, Rd, Gs^Fds, Hh^Fds, Hh^Fds, Gs, Gs, Hh
Wo, Wo, Wo, Wo, Wo, Wo, Wo, Wo, Ww, Ww, Ww, Gg, Gg, Ch, Gg, Re, Re^Vhc, Rr, Hh, Gs^Vhc, Gs^Fds, Gg, Gg, Gg, Gg, Gg, Gg, Gg, Gg, Gg, Gg, Gs^Fms, Hh, Gs^Fms, Gs^Fds, Gs^Fds, Gs^Fms, Gg, Gg, Gg, Rd, Gs^Fds, Gs^Fds, Hh^Fds, Hh, Hh, Hh
Wo, Wo, Wo, Wo, Wo, Wo, Wo, Wo, Ww, Ww, Ww, Ww, Ww, Gg, Hh, Hh, Gg, Rr, Gg, Gs^Fds, Gg, Ch, Gg, Gg, Hh, Hh, Hh, Gg, Gs^Fds, Gs^Fds, Gs^Fms, Hh^Fms, Hh, Hh, Gs^Fms, Gs^Fms, Gs^Fds, Gs^Fds, Gg, Gg, Gg, Rd, Gs^Fds, Gg, Gg, Hh, Hh
Wo, Wo, Wo, Wo, Wo, Wo, Wo, Wo, Ww, Ww, Ww, Ww, Ww, Ww, Gg^Vhc, Hh^Fds, Hh^Fds, Rr, Rr, Ch, Gg, Gg, Gg, Hh, Gg, Hh, Hh, Hh^Fds, Gs^Fms, Gs^Fms, Gs^Fp, Gs^Fp, Hh, Hh^Fms, Hh^Fp, Gs^Fms, Hh^Fds, Gg, Gg, Gg, Gg, Rd, Rd, Rd, Rd, Gg, Gg
Wo, Wo, Wo, Wo, Wo, Wo, Wo, Wo, Wo, Ww, Ww, Ww, Ww, Ww, Ww, Gs^Fds, Gs^Fds, Gs^Vhc, Gs^Fds, Rr, Rd, Gg, Rd, Gg, Gg, Hh, Hh, Hh, Hh, Hh^Fms, Hh, Hh^Fp, Hh, Hh, Hh, Hh, Hh^Fms, Gs^Fms, Gg, Gg, Gg, Gg, Gg, Gg^Vh, Rd, Gg, Gg
Wo, Wo, Wo, Wo, Ww, Wo, Wo, Wo, Ww, Ww, Ww, Ww, Ww, Ww, Ww, Ww, Gg, Gg, Ww, Ch, Gg, Rd, Gg, Rd, Rd, Gg, Gg, Gg, Gg, Hh, Hh, Hh, Hh, Mm, Mm, Hh, Hh, Hh^Fms, Hh, Gg, Gs^Fds, Gs^Fds, Gs^Fds, Gg, Gg, Rd, Rd
Wo, Wo, Wo, Wo, Ww, Ww, Ww, Ww, Ww, Ww, Wo, Wo, Wo, Ww, Ww, Ww, Ww, Ww, Ww, Ww, Ww, Gg, Gg, Gg, Gg, Rd, Rd, Gg, Gg, Gg, Hh, Hh, Hh, Mm, Mm, Mm, Hh, Hh, Hh, Hh^Fds, Hh^Fds, Gs^Fms, Gs^Fms, Rd, Gs^Fds, Gg, Gg
Wo, Wo, Ww, Ww, Gg, Gg, Gg, Ww^Bw/, Ww, Ww, Wo, Wo, Wo, Wo, Ww, Ww, Ww, Ww, Ww, Ww, Ww, Ds, Gg, Gg, Gg, Gg, Gg, Rd, Rd, Gg, Hh, Mm, Mm, Mm, Mm, Mm, Mm, Mm, Mm, Hh, Hh, Hh, Gs^Fms, Gg, Gs^Fms, Gs^Fds, Gs^Fds
Wo, Wo, Ww, Gg, Hh^Fds, Hh, Hh, Gg^Vh, Ww, Ww, Wo, Wo, Wo, Wo, Ww, Ww, Wo, Ww, Ww, Ww, Ww, Ds, Gg, Gs^Fds, Gs^Fds, Gg, Gg, Gg^Vh, Rd, Gg, Gg, Hh, Hh, Mm, Mm, Mm, Mm, Mm, Mm, Mm, Ce, Hh^Fms, Hh^Fms, Rd, Hh^Fms, Hh^Fms, Hh^Fds
Wo, Wo, Ww, Gs^Fds, Gg^Vh, Hh^Fds, Gg, Gg, Ww, Wo, Wo, Wo, Wo, Wo, Ww, Ww, Wo, Wo, Wo, Ww, Ww, Gg, Gs^Fds, Gs^Fds, Gs^Fds, Gg, Gg, Gg, Rd, Gg, Gg, Hh, Hh^Fms, Hh, Hh, Mm, Mm, Mm, Mm, Ce, 5 Ke, Ce, Rd, Rd, Hh, Hh, Hh
Wo, Wo, Wo, Ww, Ww, Gs^Fds, Ww, Gg, Ww, Ww, Ww, Ww, Ww, Ww, Ww, Wo, Wo, Wo, Wo, Ww, Ww, Ww, Ww, Gs^Fds, Gs^Fds, Gs^Fds, Gg, Gg, Rd, Gg, Gg, Gs^Fms, Hh^Fms, Hh, Hh, Hh, Mm, Hh, Hh, Ce, Ce, Ce, Rd, Hh, Mm, Mm, Mm
Wo, Wo, Wo, Ww, Ww, Ww, Ww, Ww, Gs^Fds, Gs^Fds, Gg^Vh, Ww, Ww, Ww, Wo, Wo, Wo, Wo, Wo, Wo, Ww, Ww, Ww, Gg, Gg, Gs^Fds, Gg, Gg, Rd, Gs^Fds, Gs^Fms, Gs^Fms, Gg, Hh^Fms, Hh, Mm, Mm, Hh, Gg^Vh, Hh, Hh, Rd, Gs^Fms, Hh, Mm, Mm, Mm
Wo, Wo, Wo, Wo, Wo, Wo, Ww, Ch, Ch, Hh^Fds, Hh^Fds, Gg, Ww, Ww, Wo, Wo, Wo, Wo, Wo, Wo, Ww, Ww, Ww^Bw\, Ds, Gg, Gg, Gg, Gg, Rd, Gg, Gg, Gg, Gg, Gg, Gg, Gg^Vh, Gg, Hh, Gg, Gs^Fms, Gg, Rd, Gs^Fms, Hh^Fms, Mm, Mm, Mm
Wo, Wo, Wo, Wo, Wo, Wo, Ww, 6 Kh, Gg, Hh, Hh^Fds, Gg, Ww, Ww, Wo, Wo, Wo, Wo, Wo, Wo, Ww, Ww, Ww, Ds, Gg, Gg, Gg, Gg^Vh, Rd, Gs, Gs, Gg, Gs, Hh, Gs^Fds, Gg, Gs^Fds, Gg, Rd, Rd, Gs^Fms, Gg^Vh, Hh, Hh, Mm, Mm, Hh
Wo, Wo, Wo, Wo, Wo, Wo, Wo, Ww, Ww, Gs^Fds, Gg^Vh, Gg, Ww, Ww, Ww, Wo, Wo, Wo, Wo, Wo, Ww, Ww, Ww, Ds, Gg, Gg, Gg, Rd, Ss, Gs, Ss, Gs, Gs^Fds, Gs^Fds, Gs^Fds, Gs^Fds, Gs^Fds, Gs^Fds, Gs^Fds, Gs, Gs^Fds, Gs^Fds, Gs, Hh, Hh, Hh, Hh
Wo, Wo, Wo, Wo, Wo, Wo, Wo, Ww, Ww, Ww, Ww, Ww, Ww, Ww, Ww, Ww, Ww, Wo, Ww, Ww, Ww, Ww, Gg, Gg, Gs^Fds, Gg, Gg^Vh, Rd, Ss, Ss, Ss, Ss, Ss, Ss, Gs^Fds, Gs^Fds, Gs, Gs^Fds, Gs, Gs^Fds, Ss, Ss, Ss, Gs, Gs, Gs, Gs
Wo, Wo, Wo, Wo, Wo, Wo, Wo, Wo, Wo, Wo, Wo, Wo, Wo, Wo, Wo, Wo, Wo, Ww, Ww, Ww, Ww, Ww, Gg, Gs^Fds, Gs^Fms, Gs^Fds, Gs^Fms, Rd, Rd, Ss, Gs, Ss, Gs, Ss, Gs, Gs, Hh, Gs, Ss, Ss, Ss, Ss, Ss, Ss, Ss, Gs, Gs
Wo, Wo, Wo, Wo, Wo, Wo, Wo, Wo, Wo, Wo, Wo, Wo, Wo, Wo, Wo, Wo, Wo, Ww, Ww, Ww, Ww, Ww, Gg, Gg, Gg, Gs^Fms, Gs^Fp, Gs^Fms, Gs^Fds, Rd, Rd, Gs, Gs, Gs, Gs, Gs, Hh, Hh, Hh, Hh, Gs, Ss, Gs, Ss, Gs, Gs, Gs
Wo, Wo, Wo, Wo, Wo, Wo, Wo, Wo, Wo, Wo, Wo, Wo, Wo, Wo, Wo, Wo, Wo, Ww, Ww, Ww, Ww, Ww, Gg, Gg, Gg, Gs^Fms, Gs^Fp, Gs^Fp, Gs^Fds, Gs, Rd, Gs, Gs, Gs, Hh, Hh, Hh, Hh, Hh, Hh, Hh, Gs, Gs, Gs, Gs, Gs, Gs
