Wo, Wo, Wo, Wo, Wo, Wo, Wo, Wo, Wo, Wo, Wo, Wo, Wo, Wo, Wo, Wo, Wo, Wo, Wo, Wo, Wo, Wo, Wo, Wo, Wo, Wo, Wo, Wo, Wo, Wo, Wo, Wo, Wo
Wo, Wo, Wo, Wo, Wo, Wo, Wo, Wo, Wo, Wo, Wo, Wo, Wo, Wo, Wo, Wo, Wo, Wo, Wo, Wo, Wo, Wo, Wo, Wo, Wo, Wo, Wo, Wo, Wo, Wo, Wo, Wo, Wo
Wo, Wo, Wo, Wo, Wo, Wo, Wo, Wo, Wo, Wo, Wo, Wo, Ww, Wo, Ww, Wo, Ww, Wo, Wo, Wo, Wo, Wo, Wo, Wo, Wo, Wo, Wo, Wo, Wo, Wo, Wo, Wo, Wo
Wo, Wo, Wo, Wo, Wo, Wo, Wo, Wo, Wo, Wo, Wo, Ww, Ww, Ww, Gs^Ft, Ww, Gs, Ww, Ww, Ww, Ww, Wo, Wo, Wwr, Wwr, Wo, Wo, Wo, Wo, Wo, Wo, Wo, Wo
Wo, Wo, Wo, Wo, Wo, Wo, Wo, Wo, Wo, Wwr, Wwr, Ww, Dd, Dd, Gs^Ft, Gs^Ft, Gs^Ft, Gs, Ss, Gs^Ft, Gs, Ww, Ww, Ww, Wwr, Wo, Wwr, Wo, Wo, Wo, Wo, Wo, Wo
Wo, Wo, Wo, Wo, Wo, Wo, Wo, Wo, Wwr, Wwr, Ww, Ww, Dd, Dd, Gs^Ft, Gs^Ft, Rr^Vd, Ss, Ss, Gs^Ft, Ss, Ww, Dd, Ww, Ww, Ww, Wwr, Wo, Wo, Wo, Wo, Wo, Wo
Wo, Wo, Wo, Wo, Wo, Wo, Wo, Wwr, Ww, Ww, Ww, Ww, Dd^Vdt, Dd^Do, Gs^Ft, Ss, Ss, Ss, Ss, Ss, Gs, Gs^Ft, Gs^Ft, Dd, Ww, Ww, Wwr, Wwr, Wo, Wo, Wo, Wo, Wo
Wo, Wo, Wo, Wo, Wo, Wo, Wwr, Wwr, Ww, Ww, Gs, Gs^Ft, Gs, Gs^Ft, Ss, Ss, Ss, Ss, Gs^Ft, Ss, Rr^Vd, Gs^Ft, Gs^Ft, Dd, Ww, Ww, Wo, Wo, Wo, Wo, Wo, Wo, Wo
Wo, Wo, Wo, Wo, Wo, Wwr, Ww, Ww, Ww, Ww, Ce, Ss, Ss, Ss, Gs^Ft, Gs^Ft, Gs^Ft, Gs^Ft, Gs^Ft, Gs^Ft, Gs, Gs^Ft, Gs^Ft, Dd, Dd, Ww, Wo, Wo, Wo, Wo, Wo, Wo, Wo
Wo, Wo, Wo, Wo, Wwr, Ww, Ww, Ww, Ww, Ww, Ww, Ce, 2 Ss, Ss, Gs^Ft, Gs^Ft, Gs^Ft, Gs^Ft, Hh, Gs, Hh, Gs, Gs, Gs, Dd, Ww, Ww, Wo, Wo, Wo, Wo, Wo, Wo
Wo, Wo, Wo, Wo, Ww, Ww, Ww, Ww, Ss, Ce, Ce, 1 Ke, Re, Dd^Vdt, Hh, Rr^Vd, Hh, Hh, Mm, Hh, Hh, Ch, 5 Kh, Ch, Gs, Dd, Ww, Ww, Wo, Wo, Wo, Wo, Wo
Wo, Wo, Wo, Wo, Wwr, Ww, Ww, Gs^Ft, Gs^Ft, Ss, Ss, Ss, Re, Hh, Mm, Hh, Mm, Mv, Mm, Mm, Mv, Hh, Ch, Gs, Rr^Vd, Gs, Dd^Do, Ww, Ww, Wo, Wo, Wo, Wo
Wo, Wo, Wo, Wo, Wwr, Ww, Ww, Gs^Ft, Gs^Ft, Gs, Re, Gs, Hh, Mm, Mm, Mm, Mm, Hh, Dd^Do, Mm, Mm, Mm, Mm, Hh, Hh, Gs^Ft, Gs^Ft, Gs, Gs^Ft, Ww, Wo, Wo, Wo
Wo, Wo, Wo, Wo, Wo, Ww, Ww, Ss, Ss, Rr^Vd, Gs, Hh, Hh, Mm, Hh, Hh, Hh, Hh, Gs^Ft, Hh, Hh, Mm, Mm, Hh, Hh, Ss, Ss, Gs^Ft, Gs^Ft, Ww, Wo, Wo, Wo
Wo, Wo, Wo, Wo, Wo, Ww, Ww, Ss, Gs, Hh, Re, Hh, Gs^Ft, Hh, Gs^Ft, Hh, Ss, Gs^Ft, Ss, Rr^Vd, Hh, Hh, Hh, Mm, Hh, Ss, Ss, Gs^Ft, Ss, Ww, Ww, Wo, Wo
Wo, Wo, Wo, Wo, Wo, Wo, Ww, Gs^Ft, Gs^Ft, Gs, Re, Gs^Ft, Gs^Ft, Gs^Ft, Ww, Ss, Ww, Ss, Ss, Ss, Ss, Hh, Gs^Ft, Hh, Hh, Ss, Ss, Ss, Gs^Ft, Gs, Ww, Wo, Wo
Wo, Wo, Wo, Wo, Wo, Wo, Ww, Gs^Ft, Gs^Ft, Dd^Vdt, Ww^Bw|, Ww, Ww, Ww, Ww, Ww, Wo, Ww, Ww, Ww, Ss, Ss, Gs^Ft, Hh, Hh, Ss, Ss, Rr^Vd, Gs^Ft, Gs, Ww, Wo, Wo
Wo, Wo, Wo, Wo, Wo, Wo, Wo, Ww, Ww, Ww, Ww^Bw|, Wo, Wo, Wo, Wo, Wo, Wo, Wo, Wo, Ww, Ww, Ss, Ss, Hh, Hh, Ch, Hh, Ss, Ss, Gs^Ft, Ww, Wo, Wo
Wo, Wo, Wo, Wo, Wo, Wo, Wo, Wo, Wo, Wo, Ww^Bw|, Ww, Ww, Ww, Ww, Wo, Wo, Wo, Wo, Ww, Ss, Ss, Hh, Hh, Ch, 4 Kh, Ch, Gg, Dd, Ww, Ww, Wo, Wo
Wo, Wo, Wo, Wo, Wo, Wo, Ww, Ww, Ww, Ww, Re, Gs^Ft, Gs^Ft, Ss, Ww, Wo, Ww, Wo, Ww, Ww, Ss, Ss, Rr^Vd, Hh, Hh, Hh, Gg, Gg, Dd, Ww, Ww, Wo, Wo
Wo, Wo, Wo, Wo, Wo, Ww, Gs^Ft, Gs, Rr^Vd, Ss, Re, Gs^Ft, Rr^Vd, Ss, Ss, Ww, Ss, Ww, Ss, Ss, Hh, Hh, Mm, Hh, Hh, Hh, Dd^Vda, Dd, Ww, Ww, Wo, Wo, Wo
Wo, Wo, Wo, Wo, Wo, Ww, Gs^Ft, Hh, Hh, Ss, Re, Hh, Hh, Gs^Ft, Hh, Ss, Hh, Ss, Hh, Ss, Mm, Hh, Mv, Mm, Hh, Ss, Ss, Ww, Ww, Ww, Wo, Wo, Wo
Wo, Wo, Wo, Wo, Wo, Ww, Ww, Gs, Hh, Hh, Gs, Hh, Hh, Ch, Hh, Rr^Vd, Mm, Hh, Mm, Mv, Mm, Mm, Hh, Hh, Gs^Ft, Gs^Ft, Gs, Ww, Ww, Wo, Wo, Wo, Wo
Wo, Wo, Wo, Wo, Wo, Ww, Ww, Gs, Ss, Ss, Gs^Ft, Gs, Ch, 3 Kh, Ch, Mm, Mm, Mm, Mm, Mm, Mm, Hh, Hh, Hh, Gs^Ft, Gs^Ft, Gs^Ft, Ww, Ww, Wo, Wo, Wo, Wo
Wo, Wo, Wo, Wo, Wo, Wo, Ww, Ww, Gs, Ss, Gs^Ft, Gs^Ft, Gs^Ft, Gs^Ft, Gs^Ft, Hh, Hh, Hh, Hh, Hh, Hh, Hh, Rr^Vd, Gs, Gs, Gs^Ft, Dd, Ww, Ww, Wwr, Wwr, Wo, Wo
Wo, Wo, Wo, Wo, Wo, Wo, Wo, Ww, Ww, Gs^Ft, Dd, Dd^Do, Dd, Gs^Ft, Gs, Ss, Ss, Ss, Ss, Hh, Gs^Ft, Hh, Gs^Ft, Gs, Dd, Dd, Ww, Ww, Wwr, Ww, Wo, Wo, Wo
Wo, Wo, Wo, Wo, Wo, Wo, Wo, Ww, Ww, Ww, Ww, Dd, Ww, Dd, Dd^Vda, Ss, Ss, Gs, Gs, Gs^Ft, Gs^Ft, Gs^Ft, Gs^Ft, Gs, Dd, Ww, Ww, Ww, Ww, Wo, Wo, Wo, Wo
Wo, Wo, Wo, Wo, Wo, Wo, Wo, Wo, Wo, Ww, Ww, Ww, Ww, Ww, Ww, Ww, Gs, Ss, Gs, Gs, Gs^Ft, Gs^Ft, Gs^Ft, Gs^Ft, Ww, Ww, Ww, Ww, Ww, Wwr, Wo, Wo, Wo
Wo, Wo, Wo, Wo, Wo, Wo, Wo, Wo, Wo, Wo, Wo, Wo, Wo, Ww, Ww, Ww, Ww, Gs, Dd, Dd^Vdt, Dd, Gs, Ww, Ww, Ww, Ww, Wwr, Wwr, Wo, Wo, Wo, Wo, Wo
Wo, Wo, Wo, Wo, Wo, Wo, Wo, Wo, Wo, Wo, Wo, Wo, Wo, Wo, Wo, Ww, Ww, Ww, Ww, Dd, Ww, Ww, Ww, Ww, Wwr, Ww, Wwr, Wo, Wo, Wo, Wo, Wo, Wo
Wo, Wo, Wo, Wo, Wo, Wo, Wo, Wo, Wo, Wo, Wo, Wo, Wo, Wo, Wo, Wo, Wo, Ww, Wo, Ww, Wo, Ww, Wo, Wwr, Wo, Wo, Wo, Wo, Wo, Wo, Wo, Wo, Wo
Wo, Wo, Wo, Wo, Wo, Wo, Wo, Wo, Wo, Wo, Wo, Wo, Wo, Wo, Wo, Wo, Wo, Wo, Wo, Wo, Wo, Wo, Wo, Wo, Wo, Wo, Wo, Wo, Wo, Wo, Wo, Wo, Wo
