Wo, Wo, Wo, Wo, Wo, Wo, Wo, Wo, Wo, Wo, Wo, Wo, Wo, Wo, Wo, Wo, Wo, Wo, Wo, Wo, Wo, Wo, Wo, Wo, Wo, Wo, Wo
Wo, Wo, Wo, Wo, Wo, Wo, Wo, Wo, Wo, Wo, Wo, Wo, Wo, Wo, Wo, Wo, Wo, Wo, Wo, Wo, Wo, Wo, Wo, Wo, Wo, Wo, Wo
Wo, Wo, Wo, Wo, Wo, Wo, Wo, Wo, Wo, Wo, Wo, Wo, Wo, Wo, Wo, Wo, Wo, Wo, Wo, Wo, Wo, Wo, Wo, Wo, Wo, Wo, Wo
Wo, Wo, Wo, Wo, Wo, Wo, Wo, Wo, Wo, Wo, Wo, Wo, Wo, Wo, Wo, Wo, Wo, Wo, Wo, Wo, Ww, Wo, Wwr, Wo, Wo, Wo, Wo
Wo, Wo, Wo, Wo, Wo, Wo, Ww, Wo, Wo, Wo, Wo, Wo, Wo, Wo, Wo, Wo, Wo, Wo, Ww, Ww, Cme, Ww, Ww, Wo, Wo, Wo, Wo
Wo, Wo, Wo, Wo, Ww, Ww, Cme, Ww, Ww, Wo, Wo, Wo, Wo, Wo, Wo, Wo, Wo, Ww, Ww, Dd, 4 Kme, Cme, Ww, Wo, Wo, Wo, Wo
Wo, Wo, Wo, Wo, Ww, Cme, 5 Kme, Ds, Ww, Wo, Ww, Wo, Wo, Wo, Wo, Wo, Wo, Wwr, Wwr, Dd, Dd, Hd, Ww, Wo, Wo, Wo, Wo
Wo, Wo, Wo, Wo, Ww, Ds, Ds, Ds, Ww, Ww, Ww, Ww, Ww, Wo, Wo, Wo, Wo, Wo, Wwr, Wwr, Ww, Ww, Wo, Wo, Wo, Wo, Wo
Wo, Wo, Wo, Wo, Wo, Ww, Ww, Ww, Ww, Dd, Gs^Ft, Ww, Ww, Wo, Wo, Wo, Wo, Wo, Wo, Wwr, Ww, Ww, Ww, Wo, Wo, Wo, Wo
Wo, Wo, Wo, Wo, Wo, Wo, Wo, Wo, Ww, Dd, Gs, Gs^Ft, Ww, Wo, Wo, Wwr, Wwr, Wwr, Wwr, Ww, Dd, Dd, Gs^Ft, Ww, Wo, Wo, Wo
Wo, Wo, Wo, Wo, Wo, Wo, Wo, Wo, Ww, Dd, Gs, Dd^Do, Ww, Wo, Wo, Wwr, Wwr, Ww, Dd, Dd, Dd^Do, Gs^Ft, Gs^Ft, Ww, Wo, Wo, Wo
Wo, Wo, Wo, Wo, Wo, Wo, Wwr, Wo, Ww, Dd, Ww, Gs^Ft, Ww, Wo, Wo, Wo, Ww, Ww, Gs, Gs^Ft, Hd, Hd, Ww, Ww, Wo, Wo, Wo
Wo, Wo, Wo, Wo, Wo, Wwr, Wwr, Ww, Wwr, Ww, Ww, Ww, Ww, Ww, Wo, Wo, Ww, Ww, Gs, Gs, Ww, Md, Ww, Wo, Wo, Wo, Wo
Wo, Wo, Wo, Wo, Wo, Wo, Wwr, Ww, Ww, Ww, Ww, Ww, Wo, Ww, Ww, Ww, Dd, Dd, Gs, Ww, Wo, Ww, Wo, Wo, Wo, Wo, Wo
Wo, Wo, Wo, Wo, Wo, Wo, Ww, Ww, Dd, Hd, Ww, Wo, Wo, Wo, Wo, Ww, Gs^Ft, Gs^Vht, Ww, Ww, Wo, Wo, Wo, Wo, Wo, Wo, Wo
Wo, Wo, Wo, Wo, Wo, Wo, Ww, Ww, Ww, Dd^Vda, Ww, Wo, Ww, Wo, Wo, Ww, Gs^Ft, Gs^Ft, Dd, Ww, Ww, Wo, Wo, Wo, Wo, Wo, Wo
Wo, Wo, Wo, Wo, Wo, Wo, Wo, Ww, Ww, Ww, Ww, Ww, Gs^Ft, Ww, Ww, Ww, Ww, Dd, Ww, Ww, Wo, Wo, Wo, Wo, Wo, Wo, Wo
Wo, Wo, Wo, Wo, Wo, Wo, Wo, Wo, Wo, Wo, Ww, Gs^Ft, Gs, Ww, Ww, Wo, Wo, Ww, Wo, Wo, Wo, Wo, Wo, Wo, Wo, Wo, Wo
Wo, Wo, Wo, Wo, Wo, Wo, Wo, Wo, Wo, Wo, Ww, Gs^Ft, Dd^Vda, Dd, Ww, Wo, Ww, Ww, Ww, Wo, Wo, Wo, Wo, Wo, Wo, Wo, Wo
Wo, Wo, Wo, Wo, Wo, Wo, Wo, Wo, Wo, Wo, Ww, Ww, Ww, Ww, Wo, Ww, Dd, Dd, Ww, Ww, Wo, Wo, Wo, Wo, Wo, Wo, Wo
Wo, Wo, Wo, Wo, Wo, Wo, Wo, Wo, Ww, Ww, Gs^Ft, Ww, Ww, Wo, Wo, Ww, Dd^Do, Hd, Md, Ww, Wwr, Wo, Wo, Wo, Wo, Wo, Wo
Wo, Wo, Wo, Wo, Wo, Wo, Wo, Wo, Ww, Gs^Ft, Gs^Vht, Gs, Ww, Wo, Wo, Wwr, Ww, Gs^Ft, Ww, Ww, Wo, Wo, Wo, Wo, Wo, Wo, Wo
Wo, Wo, Wo, Wo, Wo, Wo, Wo, Ww, Ww, Gs^Ft, Dd, Ww, Wwr, Wo, Wwr, Wwr, Ww, Gs, Ww, Wo, Wo, Wo, Wo, Wo, Wo, Wo, Wo
Wo, Wo, Wo, Wo, Wo, Wo, Wwr, Ww, Ww, Dd, Ww, Ww, Wwr, Wwr, Ww, Wwr, Ww, Ww, Wo, Wo, Wwr, Wo, Wo, Wo, Wo, Wo, Wo
Wo, Wo, Wo, Wo, Wwr, Wwr, Wo, Wo, Ww, Ww, Ww, Wo, Ww, Ww, Dd, Gs^Ft, Ww, Ww, Wwr, Wo, Ww, Ww, Ww, Wo, Wo, Wo, Wo
Wo, Wo, Wo, Wwr, Wwr, Wo, Ww, Ww, Ce, 2 Ww, Ce, Ww, Dd, Dd, Hd, Gs^Ft, Ww, Ww, Ww, Ww, Gs, Cme, 3 Kme, Ww, Wo, Wo, Wo
Wo, Wo, Wo, Wo, Wwr, Wwr, Ww, Dd, Ce, 1 Ke, Ce, Dd, Gs^Vht, Hd, Md, Ww, Wo, Wo, Wo, Ww, Ds, Gs, Cme, Ww, Wwr, Wo, Wo
Wo, Wo, Wo, Wwr, Wwr, Ww, Ww, Gs^Ft, Md, Hd, Ww, Gs^Ft, Ww, Gs^Ft, Ww, Ww, Ww, Wo, Ww, Ww, Ww, Ds, Ww, Wwr, Wwr, Wo, Wo
Wo, Wo, Wo, Wwr, Wo, Wwr, Wwr, Ww, Ww, Ww, Wo, Ww, Wo, Ww, Wo, Wo, Wo, Wo, Wwr, Wwr, Wwr, Ww, Wwr, Wwr, Wo, Wo, Wo
Wo, Wo, Wo, Wo, Wo, Wwr, Wo, Wo, Wo, Wo, Wo, Wo, Wo, Wo, Wo, Wo, Wo, Wo, Wwr, Wwr, Wo, Wwr, Wo, Wo, Wo, Wo, Wo
Wo, Wo, Wo, Wo, Wo, Wo, Wo, Wo, Wo, Wo, Wo, Wo, Wo, Wo, Wo, Wo, Wo, Wo, Wo, Wo, Wo, Wo, Wo, Wo, Wo, Wo, Wo
Wo, Wo, Wo, Wo, Wo, Wo, Wo, Wo, Wo, Wo, Wo, Wo, Wo, Wo, Wo, Wo, Wo, Wo, Wo, Wo, Wo, Wo, Wo, Wo, Wo, Wo, Wo
