Gs^Fds, Gs^Fds, Gs^Fds, Gs^Fds, Gs^Fds, Gs^Fds, Gs^Fds, Gs^Fds, Gs^Fds, Gs^Fds, Gs^Fds, Gs^Fds, Gs^Fms, Gs^Fds, Gs^Fms, Gs^Fds, Gs^Fms, Gs^Fp, Gs^Fp, Gs^Fp, Gs^Fp, Gs^Fp, Gs^Fp, Gs^Fp, Gs^Fp, Gs^Fp, Gs^Fms, Gs^Fp, Gs^Fp, Gs^Fp, Gg, Gg, Gg, Gs^Fp, Gs^Fp, Gs^Fp, Gs^Fp
Gs^Fds, Gs^Fds, Gs^Fds, Gs^Fds, Gs^Fds, Gs^Fds, Gs^Fds, Gs^Fds, Gs^Fds, Gs^Fds, Gs^Fds, Gs^Fds, Gs^Fms, Gs^Fds, Gs^Fp, Gs^Fms, Gs^Fms, Gs^Fp, Gs^Fp, Gs^Fp, Gs^Fp, Gs^Fp, Gs^Fp, Gs^Fp, Gs^Fms, Gs^Fms, Gs^Fms, Gs^Fms, Gs^Fp, Gg, Gg, Gg, Gg^Vh, Gg, Gs^Fp, Gs^Fp, Gs^Fp
Gs^Fds, Gs^Fds, Gs^Fds, Gs^Fds, Gs^Fds, Gs^Fds, Gs^Fds, Gs^Fds, Gs^Fds, Gs^Fds, Gs^Fds, Gs^Fds, Gs^Fms, Gs^Fds, Gs^Fms, Gs^Fms, Gs^Fp, Gs^Fp, Gs^Fp, Gg^Vh, Gs^Fp, Gg, Gs^Fp, Gs^Fp, Gs^Fp, Gs^Fds, Gs^Fds, Gs^Fms, Gs^Fp, Gg, Gs^Fp, Gg, Gs, Gs, Gs, Gs^Fp, Gs^Fp
Gs^Fds, Gs^Fds, Gs^Fds, Gs^Fds, Gg, Gs^Fds, Gs^Fds, Gs^Fds, Gs^Fds, Gs^Fds, Gs^Fds, Gs^Fds, Gs^Fds, Gs^Fms, Gs^Fms, Gs^Fp, Gs^Fp, Gs^Fp, Gs^Fp, Gs^Fp, Gg, Gs^Fp, Gs^Fp, Gg, Gg, Gg, Gg, Gs^Fds, Gs^Fms, Gs^Fp, Gg, Gs, Ss, Ss, Ss, Gs, Gs
Gs^Fds, Gs^Fds, Gs^Fds, Gs^Fds, Gs^Fds, Gg^Vh, Gs^Fds, Gs^Fds, Gs^Fds, Gs^Fds, Gs^Fds, Gg, Gg, Gg, Gg, Gs^Fms, Gs^Fms, Gs^Fms, Gs^Fp, Gs^Fp, Gs^Fp, Gg, Gs^Fp, Gg, Gs^Fp, Gg, Gg, Gg, Gg, Gs, Gs, Ss, Ss, Ss^Vhs, Ss, Ss, Ss
Gs^Fds, Gs^Fds, Gs^Fds, Gs^Fds, Gs^Fds, Gs^Fds, Gs^Fds, Gs^Fds, Gs^Fds, Gs^Fds, Gg, Gs, Ce, 2 Gg, Gg, Gs^Fms, Gs^Fp, Gs^Fp, Gg, Gs^Fp, Gg, Gg, Gg, Gs^Fp, Gg, Gg, Gg, Gs, Gs, Gs, Gs, Gs, Ss, Gs, Gs, Ss, Ss
Gs^Fds, Gs^Fds, Gs^Fds, Gs^Fds, Gs^Fds, Gs^Fds, Gs^Fds, Gs^Fds, Gs^Fds, Gg, Gs, Ce, 1 Ke, Ce, Gs, Gs^Fms, Gs^Fms, Gg, Gs^Fms, Gg, Gs^Fms, Gs^Fp, Gg, Gg, Gg, Gs, Ss, Ss, Ss, Ss, Ss, Gs, Ww^Bw\, Ss, Ss, Ss, Ss
Gs^Fds, Gs^Fds, Gs^Fds, Gs^Fds, Gs^Fds, Gs^Fds, Gs^Fds, Gs^Fds, Gs^Fds, Gg, Gs, Ce, Ce, Ce, Gs, Gg, Gs^Fds, Gs^Fds, Gs^Fds, Gs^Fms, Gs^Fp, Gg, Gg, Gg^Vh, Gg, Gg, Ss, Ss, Ss, Ww, Ww, Ss, Gs^Fds, Gs, Ss, Ww, Ww
Gs^Fds, Gs^Fds, Gs^Fds, Gs^Fds, Gs^Fds, Gs^Fds, Gs^Fds, Gs^Fds, Gg, Gg, Gg^Vh, Gs, Gs, Gs, Gs^Fds, Gs, Gg, Gg, Gg, Gg, Gg, Gg, Gs^Fds, Gg, Gg, Gs, Ss, Gs, Ss, Ww, Ss, Ss, Ss, Gs, Ss, Ww, Ww
Gs^Fds, Gs^Fds, Gs^Fds, Gs^Fds, Gs^Fds, Gs^Fds, Gg, Gs^Fds, Gg, Gg, Gg, Gs, Gg, Gs^Fds, Gg, Gs, Gs, Gg^Vh, Gg, Gg, Gg, Gs^Fds, Gs^Fds, Gg, Gg, Gs, Ss, Ss, Ww, Ss, Gs, Ss, Ww, Ww^Bw|, Ss, Ss^Vhs, Ss
Gs^Fds, Gs^Fds, Gs^Fds, Gg, Gg, Gg, Gg, Gs^Fds, Rd, Rd, Gs^Fds, Gg, Gg, Gg, Gs^Fds, Gg, Gs, Gs, Gs, Gg, Gg, Gs^Fds, Gs, Ss, Gs, Gg, Gs, Ss, Ss, Ss, Ss, Ss, Ss, Ww^Bw|, Ss, Ss, Ss
Gs^Fds, Gs^Fds, Gg, Gg, Gg, Gg^Vh, Rd, Rd, Gg, Gs^Fds, Gs^Fds, Gg, Gg, Gg, Gs^Fds, Gg, Gs^Fds, Gs^Fds, Gs, Gs, Gs, Gg, Gg, Ss, Ss, Gs, Ss, Gs, Ss, Ww, Ss, Gs, Gs, Gs, Ss, Gs, Gs
Gg, Gg, Gs^Fds, Gg, Rd, Rd, Gg, Gg, Gg, Gg, Gg, Gg, Gg, Gs^Fds, Gg, Gs^Fds, Gs^Fds, Gg, Gs^Fds, Gs, Gs, Gg^Vh, Gg, Ss, Ss, Ss^Vhs, Ww, Ss, Ss, Ss, Gs^Fds, Ss, Ww, Ww^Bw|, Ww, Ss, Ss
Gg, Gg, Gg, Gg, Rd, Rd, Ss, Gg, Ss, Gg, Gg, Gg, Gg, Gg, Gg, Gg, Gg, Gg, Gs, Gs, Ss, Gs, Gg, Gs^Fds, Gs^Fds, Ss, Ww, Ww, Ss^Vhs, Gs^Fds, Chr, Gs^Fds, Gs^Fds, Ww^Bw|, Ss, Ww, Ww
Ss, Ss, Ss, Ss, Ss, Ww^Bw\, Ww^Bw\, Ss, Ss, Gs^Fds, Gs^Fds, Gg, Ss, Ss, Ss, Ss, Ss, Gg, Gs, Gg, Ss, Gs, Gs, Gg, Gg, Ss, Ss, Ww, Ss, Ss, Gs^Fds, 4 Khr, Chr, Gs, Ss, Ww, Ww
Ww, Ww, Ss, Rd, Ss, Ss, Ss, Rd, Ss, Ss, Ss, Ss, Ss, Gg, Ss, Ss, Ww^Bw/, Ww^Bw/, Gg, Ss, Ss, Ss, Gg, Gs, Ww^Bw\, Ss, Gs^Fds, Ss, Ss, Ss, Ss, Chr, Ss, Ww^Bw|, Gg, Ss, Ss
Ss, Ss, Ww, Ss, Ww, Ss^Vhs, Ss, Ww^Bw|, Ss, Ww, Ww, Ww, Ww, Ss, Ss, Gg, Ss, Ss, Ss, Ss, Gg, Gs^Fds, Gg, Ss, Ss, Gs, Gs, Gs^Fds, Gs^Fds, Ss, Ww, Ww, Ss, Gs, Gg, Gs^Fds, Gs^Fds
Ww, Ww, Ww, Ww, Ww, Ss, Ww^Bw/, Rd, Ss, Ww, Ss, Ww, Ss, Ww, Ss, Ww^Bw|, Ss, Ww, Ss, Gg, Gs^Fds, Gs^Fds, Gg, Ss, Gg, Gs^Fds, Gg, Gs, Ww^Bw\, Ss, Ss, Ss, Ww^Bw/, Ww^Bw/, Ss, Gs^Fds, Gs^Fds
Ss, Ss, Ss, Ss, Ww^Bw/, Ww^Bw/, Ww, Ss, Rd, Ss^Vhs, Gg, Ss, Gg, Ss, Gg, Ww^Bw|, Ss, Ww, Ww, Ss, Ss, Gs^Fds, Gg, Ss, Gg, Ss, Gg, Gg, Ss, Gs, Ww^Bw/, Gs, Ss, Ww, Ww, Ss, Ss
Gs^Fds, Gs^Fds, Chr, Rd, Ss, Ww, Ss, Ss, Ss, Ss, Ss, Gg, Gg, Ss, Gg^Vh, Gg, Ss, Ww, Ss, Ss^Vhs, Ss, Ss, Ss, Ss, Ss, Ss, Ss, Ss, Ss, Gs, Ss, Gs^Fds, Gs^Fds, Ss, Ww, Ww, Ww
Gs^Fds, Gs^Fds, 3 Khr, Chr, Ww, Ss, Ss^Vhs, Gs^Fds, Gs^Fds, Gs^Fds, Gs^Fds, Ss, Gg, Ss, Ww^Bw/, Gg, Gg, Ss, Gg, Ss, Ww, Ww, Ww, Ww, Ss, Ss, Ss, Ww, Ss, Ww^Bw|, Ss, Gg, Ss, Ss, Ww, Ww, Ww
Gs^Fds, Gs^Fds, Chr, Rd, Ww^Bw\, Ss, Ss, Gg, Gs^Fds, Gs^Fds, Gs^Fds, Gs^Fds, Gg, Gg, Hh, Ss, Ss, Ss, Ss, Ss, Ss, Ss, Ss, Ss, Ss, Gg, Gs^Fds, Ss, Ww^Bw/, Gs, Gs, Ss, Ss, Ss, Ww, Ww, Ww
Ss, Ss, Ww, Ww, Ss, Ww^Bw\, Ww^Bw\, Gg, Gg, Gs^Fds, Gs^Fds, Gs^Fds, Gs^Fds, Gg, Gg, Hh, Hh^Fds, Gs^Fds, Gs^Fds, Gs^Fds, Gs^Fds, Gs^Fds, Gs^Fds, Gs, Gs^Fds, Gs^Fds, Gs, Gs, Gs^Fds, Ss, Ss, Ww^Bw\, Ww^Bw\, Ww, Ss, Ww, Ww
Ww, Ww, Ww, Ww, Ss, Ss, Ss, Rd, Ss, Gg, Ss, Gs^Fds, Gg, Gs^Fds, Gs^Fds, Gg, Gg, Gs^Fds, Gs^Fds, Gs^Fds, Rd, Rd, Gs^Fds, Gs^Fds, Rd, Gs, Gs, Gs^Fds, Ss, Ss, Ww, Ww, Ss, Ww^Bw\, Ww^Bw\, Ss, Ss
Ww, Ww, Ww, Ss^Vhs, Ss, Gg, Ss, Rd, Rd, Ss, Gg, Gg, Gg, Gs^Fds, Rd, Rd, Rd, Rd, Rd, Rd, Rd, Rd, Rd, Rd, Rd, Gs, Rd, Ss, Ss, Ww, Ww, Ww, Ss, Chs, Chs, Gs, Gs
Ss, Ss, Ss, Ss, Ss, Gg, Ss, Ss, Ss, Rd, Rd, Rd, Rd, Rd, Rd, Rd, Gs^Fds, Rd, Hh, Hh, Hh, Hh, Hh^Fds, Rd, Gs^Fds, Rd, Ss, Gs, Ss, Ww, Ss, Ss, Chs, 5 Khs, Gs^Fds, Gs, Gs
Ss, Ss, Ss, Gg, Ss, Ss, Ss, Ww, Ss, Ss, Rd, Gg, Gs^Fds, Gs^Fds, Hh^Fds, Hh, Hh, Hh, Hh, Hh, Mm, Hh, Hh^Fds, Hh^Fds, Rd, Rd, Rd, Ss^Vhs, Ss, Ww, Ww, Ss, Ss, Chs, Ss, Gs, Gs
Gs^Fds, Gs^Fds, Gs^Fds, Ss, Ss, Ss, Ss^Vhs, Ss, Gg, Gg^Vh, Rd, Gs^Fds, Gs^Fds, Hh^Fds, Hh^Fds, Hh, Mm, Mm, Mm, Mm, Mm, Mm, Hh, Rd, Gs^Fds, Rd, Ww^Bw\, Ss, Gs, Ss, Ww, Ss^Vhs, Ww, Ww, Ss, Gs, Gs
Ss, Ss, Ss, Gg, Ss, Ss, Rd, Ss, Gg, Gg, Rd, Rd, Rd, Hh, Hh, Mm, Mm, Mm, Mm, Mm, Rr, Hh, Rd, Rd, Rd, Ss, Ss, Rd, Rd, Ss, Ss, Ww, Ss, Ss, Ww^Bw/, Gs, Gs
Ww, Ww, Ww, Ss, Ss, Ss, Ss, Ss, Ss, Rd, Chr, Gg, Gg, Hh, Hh, Hh, Mm, Mm, Hh, Hh, Hh, Rr, Rd, Gs^Fds, Rd, Ss, Ww, Ss, Ss, Gs, Rd, Gs, Gs, Gs, Ss, Gs, Gs^Fds
Ss, Ss, Ss, Ss, Ss, Ss, Ss^Vhs, Rd, Rd, Chr, 6 Khr, Ss, Ss, Gs^Fds, Gs^Fds, Hh^Fds, Hh^Fds, Hh, Hh, Rd, Rd, Rd, Ss, Ss, Rd, Ss, Ww, Ww, Ss, Ss, Gg, Gg^Vh, Ss, Gs, Gs^Fds, Gs^Fds, Gs^Fds
Gs^Fds, Gs^Fds, Gg, Gg, Gs^Fds, Ss, Ss, Ss, Ss, Ss, Chr, Chr, Rd, Ss, Rd, Hh^Fds, Gs^Fds, Rd, Gs^Fds, Rd, Gg, Gg^Vh, Gg, Ss, Ss, Ss, Ww, Ww, Ss, Gg, Ss, Ss, Ww, Ss, Gs^Fds, Gs^Fds, Gs^Fds
Gg, Gg, Ss^Vhs, Ss, Gs^Fds, Gs^Fds, Ss, Ww, Ww, Ss, Ss, Gg, Ss, Ss^Vhs, Ss, Rd, Gs^Fds, Gs^Fds, Gs^Fds, Rd, Gg, Gg, Ss, Ss, Ww, Ww, Ss, Ww, Ww, Ss, Ww, Ww, Ww, Ss, Gs^Fds, Ss, Ss
Ss, Ss, Ss, Ss, Gs^Fds, Gs^Fds, Ss, Ss, Ss, Ss, Ss, Ss, Gg, Ss, Gs^Fds, Hh^Fds, Gg, Hh^Fds, Gg, Gg, Ss, Ss, Ss, Ww, Ss, Ss, Gs^Fds, Ss, Ss, Ww, Ss, Ss, Ss, Ss, Ss^Vhs, Ss, Ss
Gs^Fds, Gs^Fds, Gs^Fds, Ss, Gs^Fds, Ss, Gs^Fds, Gs^Fds, Ss, Gg, Ss^Vhs, Ss, Ss, Ss, Ss, Ss, Ss, Hh^Fds, Ss, Ss, Ss, Ss, Gg, Ss, Gg, Ss, Gg, Gs^Fds, Ss, Ss^Vhs, Ss, Gs^Fds, Gs^Fds, Ss, Ss, Ww, Ww
Gs^Fds, Gs^Fds, Gs^Fds, Gs^Fds, Gs^Fds, Ss, Gs^Fds, Ss, Ss, Gg, Gg, Ss, Ww, Ww, Ww, Ss, Ss, Ss, Gg^Vh, Ss, Ww, Ss, Ss, Ss, Ss, Ss, Ss, Ss, Ss, Ss, Gs, Gs^Fds, Ss, Ss, Ss, Ww, Ww
Gs^Fds, Gs^Fds, Gs^Fds, Gs^Fds, Gs^Fds, Gs^Fds, Gs^Fds, Gg, Ss, Ss, Ss, Ss, Ww, Ww, Ww, Ss, Ss, Gg, Gg, Ss, Ww, Ww, Ss, Ss, Gg, Gg, Ss, Ss, Ss, Gs, Gs, Gs^Fds, Gs^Fds, Gs^Fds, Ss, Ss, Ss
Gs^Fds, Gs^Fds, Gs^Fds, Gs^Fds, Gs^Fds, Gs^Fds, Gs^Fds, Gg, Ss, Ss, Ss, Ss, Ss, Ww, Ss, Ss, Ss, Gg, Gg, Ss, Ss, Ss, Ss, Ss, Ss, Gg, Gg, Ss, Ss, Gs, Gs, Gs^Fds, Gs^Fds, Gs^Fds, Gs^Fds, Ss, Ss
