Xu, Xu, Xu, Xu, Xu, Xu, Xu, Xu, Xu, Xu, Xu, Xu, Xu, Xu, Xu, Xu, Xu, Xu, Xu, Xu, Xu, Xu, Xu, Xu, Xu, Xu, Xu, Xu, Xu, Xu, Xu, Xu
Xu, Xu, Xu, Xu, Xu, Xu, Xu, Xu, Xu, Xu, Xu, Xu, Xu, Xu, Xu, Xu, Xu, Xu, Xu, Xu, Xu, Xu, Xu, Xu, Xu, Xu, Xu, Xu, Xu, Xu, Xu, Xu
Xu, Xu, Xu, Xu, Uu^Tf, Uu^Vu, Uh, Xu, Xu, Xu, Xu, Xu, Xu, Xu, Xu, Xu, Xu, Xu, Xu, Xu, Xu, Xu, Uu^Vu, Xu, Uu^Tf, Xu, Uu^Vu, Xu, Uu^Tf, Xu, Xu, Xu
Xu, Xu, Uh, Uh, Uu^Tf, Uu^Tf, Uu^Tf, Uu, Uu^Vu, Xu, Xu, Xu, Uu, Uu^Vu, Uu, Uu^Tf, Uu, Xu, Xu, Xu, Xu, Uh, Uu^Tf, Uu^Tf, Uu, Uu, Uu, Uu, Uu^Tf, Xu, Xu, Xu
Xu, Xu, Uu, Uu, Cte, Uh, Cte, Uu, Uu, Xu, Xu, Xu, Uu, Uu, Uu, Uu, Uu, Uu, Xu, Xu, Xu, Xu, Uu, Uu, Cte, Uu, Cte, Uu, Uu^Vu, Xu, Xu, Xu
Xu, Xu, Uu^Vu, Uu, Cte, 3 Kte, Cte, Uu, Xu, Xu, Xu, Xu, Uu, Uu, Xu, Xu, Xu, Uu, Xu, Xu, Xu, Xu, Uu, Ur, Cte, 4 Kte, Cte, Uu, Uh, Uh, Xu, Xu
Xu, Xu, Uu, Uu, Uu, Uu, Uu, Uu, Uu, Uu^Vu, Uu, Uu, Uu^Tf, Uu, Uu, Xu, Uu, Uu, Uh, Uh, Xu, Uu^Vu, Ur, Ur, Uu, Ur, Ur, Uu, Uh, Uh, Xu, Xu
Xu, Xu, Uh, Uu, Uh, Uu, Uu, Uu, Xu, Uu, Uu, Uu^Tf, Xu, Xu, Uu, Uu, Uu, Xu, Xu, Uh, Uu, Uu, Uu, Xu, Uu, Ur, Uu^Vu, Uu, Xu, Uh, Xu, Xu
Xu, Xu, Uh, Uu^Vu, Xu, Xu, Uh, Uu, Uu, Xu, Uu, Xu, Uu, Uu, Xu, Uu^Vu, Xu, Uu, Uu, Xu, Uu, Xu, Uu, Uu, Xu, Xu, Xu, Xu, Xu, Xu, Xu, Xu
Xu, Xu, Xu, Uh, Xu, Xu, Xu, Uu, Uu, Uu, Xu, Uu, Ur, Uu^Tf, Xu, Xu, Xu, Xu, Uu, Uu, Xu, Uu, Uu, Uu, Xu, Xu, Xu, Xu, Xu, Xu, Xu, Xu
Xu, Xu, Xu, Xu, Xu, Xu, Xu, Xu, Uu, Uu, Xu, Uh, Ur, Xu, Xu, Xu, Xu, Xu, Uu, Xu, Uh, Uu, Uu, Uu, Uu, Xu, Xu, Xu, Xu, Xu, Xu, Xu
Xu, Xu, Xu, Xu, Xu, Xu, Uh, Uu, Uu, Uu, Xu, Xu, Uu, Xu, Ww, Ww, Ww, Xu, Uu, Xu, Xu, Xu, Uu, Xu, Uu, Xu, Xu, Xu, Xu, Xu, Xu, Xu
Xu, Xu, Xu, Xu, Xu, Uh, Uu, Uu, Xu, Ur, Ur, Uu, Ww^Bw\, Ww, Ww^Ii, Ww^Ii, Ww^Ii, Ww, Ww^Bw/, Uu, Uu^Ii, Uu, Xu, Uu, Uu, Uu^Tf, Xu, Xu, Xu, Xu, Xu, Xu
Xu, Xu, Xu, Xu, Xu, Xu, Uu, Uu^Tf, Xu, Xu, Ur, Ww, Ww, Ww^Bw\, Ur^Ii, Uh^Ii, Ur^Ii, Ww^Bw/, Ww, Ww^Ii, Uu^Ii, Xu, Xu, Uu, Uu, Uu, Xu, Xu, Xu, Xu, Xu, Xu
Xu, Xu, Xu, Uh, Uu, Uu, Xu, Uu, Uu, Uu, Xu, Ww, Ww^Ii, Ur, Cud, Cud^Ii, Cud, Uu, Ww, Ww, Xu, Uu, Uu, Uu, Uh, Uu, Uu, Uh, Uh, Xu, Xu, Xu
Xu, Xu, Xu, Uu, Uu, Xu, Uu^Vu, Xu, Uu, Xu, Xu, Ww^Ii, Ww^Ii, Uu^Ii, Cud, 1 Kud, Cud, Uu^Vu, Ww^Ii, Ww, Xu, Xu, Uu, Xu, Xu, Xu, Uu^Vu, Uu, Uh, Xu, Xu, Xu
Xu, Xu, Xu, Uu, Uu, Uu, Xu, Xu, Uu, Uu^Vu, Xu, Ww^Ii, Ww^Ii, Ur^Ii, Ur, 2 Cud, Ur, Uu^Ii, Ww^Ii, Ww^Ii, Xu, Uu^Vu, Uu, Uu^Tf, Xu, Xu, Uu, Uu, Xu, Xu, Xu, Xu
Xu, Xu, Xu, Xu, Uu^Tf, Uu, Uu, Uu, Uu, Xu, Xu, Ww, Ww, Uu, Uu^Vu, Ur, Uu, Uu^Ii, Ww^Ii, Ww^Ii, Xu, Xu, Ur, Uu, Uu, Uu, Uu, Uu^Tf, Uu^Tf, Xu, Xu, Xu
Xu, Xu, Xu, Xu, Xu, Uu^Tf, Uu, Xu, Xu, Uu, Uu^Ii, Ww^Ii, Ww^Bw/, Ww^Bw/, Ww, Uh, Ww, Ww^Bw\, Ww^Bw\, Ww, Uu, Ur, Xu, Xu, Uu, Uu, Xu, Uu^Tf, Xu, Xu, Xu, Xu
Xu, Xu, Xu, Xu, Xu, Uh, Uh, Uu, Uu, Uu, Xu, Ur^Ii, Ur, Ww, Ww^Ii, Ww^Ii, Uh^Ii, Ww, Uu, Uu, Xu, Uu, Uu, Uu, Xu, Uh, Xu, Xu, Xu, Xu, Xu, Xu
Xu, Xu, Xu, Xu, Xu, Xu, Uh, Uu, Uu, Xu, Xu, Xu, Uu, Xu, Xu, Uh^Ii, Uh, Xu, Uu^Ii, Xu, Xu, Xu, Uu, Uu, Xu, Xu, Xu, Xu, Xu, Xu, Xu, Xu
Xu, Xu, Xu, Xu, Xu, Xu, Uu, Uu, Ur, Uu^Tf, Xu, Uh, Uu, Xu, Xu, Xu, Xu, Xu, Uu, Xu, Xu, Uu^Vu, Uu, Uu, Uu, Uu^Vu, Xu, Xu, Xu, Xu, Xu, Xu
Xu, Xu, Xu, Xu, Xu, Uu^Vu, Uu, Uu^Tf, Xu, Ur, Ur, Ur, Xu, Uu, Uu, Uu^Vu, Uu, Uu, Xu, Uu, Uu, Uu, Xu, Uu, Ur, Uu, Uu, Xu, Uu^Vu, Xu, Xu, Xu
Xu, Xu, Uh, Uu^Vu, Uu, Uu, Uu, Xu, Uu, Uu^Vu, Uu, Uu, Uu^Tf, Xu, Uu, Uu, Uu, Xu, Uu, Uu, Xu, Uu, Uu, Xu, Ur, Ur, Uu, Uu, Uu^Tf, Xu, Xu, Xu
Xu, Xu, Uu, Uu, Cte, Uu, Cte, Uu, Xu, Uu, Uu^Tf, Uu, Uu, Uu, Xu, Xu, Xu, Uu, Uu, Xu, Xu, Xu, Xu, Uu, Cte, Ur, Cte, Uu, Uu^Tf, Uu^Tf, Xu, Xu
Xu, Xu, Uu^Tf, Uu, Cte, 5 Kte, Cte, Uu, Uh, Xu, Xu, Xu, Xu, Uu, Xu, Uu^Vu, Uu, Uu, Uh, Uh, Xu, Xu, Uu, Uu^Vu, Cte, 6 Kte, Cte, Uu^Tf, Uu^Tf, Xu, Xu, Xu
Xu, Xu, Uu^Tf, Uu, Uu, Uu, Uh, Uh, Uh, Xu, Xu, Xu, Xu, Uu, Uu, Uu, Uu, Uu, Uu^Tf, Xu, Xu, Uu, Xu, Uu, Uu, Uh, Uh, Uu^Tf, Uh, Xu, Xu, Xu
Xu, Xu, Xu, Uu^Vu, Uu, Uu, Uh, Uh, Uh, Xu, Xu, Xu, Xu, Xu, Xu, Uu^Tf, Xu, Uu^Tf, Xu, Xu, Xu, Xu, Xu, Uu, Uu, Uu, Uu, Uu, Uh, Xu, Xu, Xu
Xu, Xu, Xu, Xu, Uu^Tf, Uu^Vu, Xu, Xu, Xu, Xu, Xu, Xu, Xu, Xu, Xu, Xu, Xu, Xu, Xu, Xu, Xu, Xu, Xu, Xu, Xu, Uu^Vu, Xu, Uh, Xu, Xu, Xu, Xu
Xu, Xu, Xu, Xu, Xu, Xu, Xu, Xu, Xu, Xu, Xu, Xu, Xu, Xu, Xu, Xu, Xu, Xu, Xu, Xu, Xu, Xu, Xu, Xu, Xu, Xu, Xu, Xu, Xu, Xu, Xu, Xu
Xu, Xu, Xu, Xu, Xu, Xu, Xu, Xu, Xu, Xu, Xu, Xu, Xu, Xu, Xu, Xu, Xu, Xu, Xu, Xu, Xu, Xu, Xu, Xu, Xu, Xu, Xu, Xu, Xu, Xu, Xu, Xu
Xu, Xu, Xu, Xu, Xu, Xu, Xu, Xu, Xu, Xu, Xu, Xu, Xu, Xu, Xu, Xu, Xu, Xu, Xu, Xu, Xu, Xu, Xu, Xu, Xu, Xu, Xu, Xu, Xu, Xu, Xu, Xu
