Wo, Wo, Wo, Wo, Wo, Wo, Wo, Wo, Wo, Wo, Wo, Wo, Wo, Wo, Wo, Wo, Wo, Wo, Wo, Wo, Wo, Wo, Wo, Wo, Wo, Wo, Wo, Wo, Wo, Wo, Wo, Wo, Wo, Wo, Wo
Wo, Wo, Wo, Wo, Wo, Wo, Wo, Wo, Wo, Wo, Wo, Wo, Wo, Wo, Wo, Wo, Wo, Wo, Wo, Wo, Wo, Wo, Wo, Wo, Wo, Wo, Wo, Wo, Wo, Wo, Wo, Wo, Wo, Wo, Wo
Wo, Wo, Wo, Wo, Ww, Wwr, Wwr, Wo, Wo, Wo, Wo, Wo, Wo, Wo, Wo, Wwr, Wwr, Wwr, Wwr, Wo, Wo, Wo, Wo, Wo, Wo, Wo, Wo, Wo, Ww, Ww, Ww, Ww, Ww, Wo, Wo
Wo, Wo, Ww, Ww, Ww, Wwr, Ww, Ww, Ww, Wo, Ww, Ww, Ww, Ww, Ww, Ww, Ww, Ww, Wwr, Wwr, Wo, Wo, Wo, Wo, Wo, Wo, Ww, Ww, Ww, Gs, Gs^Fds, Gs^Fds, Ww, Wo, Wo
Wo, Wo, Ww, Wwr, Wwr, Dd, Ww, Ww, Ww, Ww, Ww, Hd^Qhh, Hd^Qhh, Hd^Qhh, Ww, Hd^Qhh, Ww, Ww, Ww, Wwr, Wo, Wo, Wo, Wo, Wo, Wo, Wo, Ww, Gg^Vc, Ss, Ss, Gs^Fds, Ww, Wo, Wo
Wo, Wo, Ww, Wwr, Dd, Dd^Vda, Dd, Dd, Dd, Dd, Dd, Hd^Qhh, Hd, Md, Md, Md, Hd^Qhh, Ww, Ww, Wo, Wwr, Wo, Wo, Wo, Wo, Wo, Wo, Ww, Gs, Gs, Ss, Gs^Fds, Ww, Wo, Wo
Wo, Wo, Ww, Gs^Ft, Dd, Gs^Ft, Dd, Cvr^Edb, Cvr^Edb, Cvr^Edb, Dd, Ww, Dd^Vda, Md, Mv, Hd, Hd, Gs^Ft, Ww, Ww, Ww, Ww, Ww, Wo, Wo, Wo, Wo, Ww, Ww, Ww, Gs^Fds, Ww, Wo, Wo, Wo
Wo, Wo, Wo, Ww, Gs^Ft, Gs^Ft, Gs^Ft, Cvr^Edb, 4 Kvr, Cvr^Edb, Dd, Dd, Hd, Hd, Md, Md, Hd, Gs^Ft, Gs^Fds, Gs^Fds, Gg^Vc, Ww, Ww, Ww, Wo, Wo, Wo, Wo, Ww, Ww, Ww, Ww, Wo, Wo, Wo
Wo, Wo, Wo, Ww, Ww, Ww, Gs^Ft, Dd^Edb, Dd^Edb, Dd^Edb, Hd, Gs^Ft, Md, Mv, Md, Hd, Gs^Ft, Gs^Ft, Gs^Fds, Gs^Fds, Gs^Fds, Gs^Fds, Ww, Ww, Ww, Wo, Wo, Ww, Ww^Bw\, Ww, Ww, Wo, Wo, Wo, Wo
Wo, Wo, Wo, Wo, Ww, Ww, Gs^Ft, Gs^Ft, Dd^Do, Dd^Edb, Md, Hd, Md, Md, Md, Hd, Gs^Ft, Dd, Gs^Fds, Gs^Fds, Gs^Fds, Gs^Fds, Gs^Fds, Gs^Fds, Ww, Wo, Ww, Ww, Gs, Gg^Vc, Ww, Ww, Wo, Wo, Wo
Wo, Wo, Wo, Wo, Ww, Ww, Ww, Ww, Gs^Ft, Hd, Gs^Ft, Hd, Md, Hd, Hd, Hd, Dd, Dd, Dd, Gs^Fds, Gs^Ft, Gs^Fds, Gs^Fds, Gs^Fds, Ww, Ww, Ww, Ww, Gs, Gs, Gs^Fds, Ww, Ww, Wo, Wo
Wo, Wo, Wo, Wo, Ww, Ww, Ww, Ww, Gs^Ft, Gs^Ft, Dd, Hd, Hd, Gs^Vht, Gs^Ft, Hd, Dd, Dd, Dd, Gs^Fds, Gs^Ft, Ss, Gs^Fds, Gs^Ft, Gs, Dd, Ww, Ww, Ce, Ce, Gs^Fds, Dd, Ww, Wo, Wo
Wo, Wo, Wo, Wo, Wo, Wo, Wwr, Ww, Dd, Dd, Gs^Ft, Dd, Gs^Ft, Gs^Ft, Gs^Ft, Dd, Gs^Ft, Dd, Gs^Ft, Gs^Fds, Gs^Fds, Gs^Fds, Gs^Fds, Gs^Fds, Gg^Vc, Ww, Ww, Ww, Ww, 1 Ke, Ce, Dd, Ww, Wo, Wo
Wo, Wo, Wo, Wo, Wo, Wo, Wwr, Wwr, Dd, Gs^Ft, Gll^Ftr, Exos, Exos, Ss, Ss, Gs^Fds, Gs^Ft, Gs^Fds, Re, Re, Gs^Fds, Gs^Fds, Gs^Fds, Gs^Fds, Gs, Gs, Ww, Ww, Ww, 2 Ce, Ww, Dd, Ww, Wo, Wo
Wo, Wo, Wo, Wo, Ww, Wwr, Wwr, Dd, Dd, Gs^Ft, Gll^Ftr, Exos, Re, Gll^Ftr, Re, Re, Gs^Fds, Gs^Ft, Gs^Fds, Re, Gs^Ft, Gs^Fds, Gs^Ft, Gs^Vht, Gs^Fds, Gs^Fds, Gs, Ww, Ww, Ww, Dd, Ww, Wo, Wo, Wo
Wo, Wo, Wo, Ww, Ww, Gs^Qhh, Gs^Qhh, Gs^Ft, Gs^Ft, Exos, Exos, Gll^Ftr, Gll^Ftr, Gll^Ftr, Gs^Fds, Gs^Fds, Gs^Fds, Gs^Fds, Gs^Fds, Re, Re, Re, Gs^Ft, Gg, Gs^Fds, Gs^Fds, Gs, Gs, Gg^Vc, Gs^Ft, Ww, Ww, Wo, Wo, Wo
Wo, Wo, Ww, Ww, Ww, Gs^Qhh, Gs^Fds, Gs^Vht, Gll^Ftr, Exos, Gll^Ftr, Gs^Ft, Gll^Ftr, Ss, Gs^Ft, Gs^Fds, Gs^Fds, Re, Re, Gs^Fds, Gs^Fds, Gs^Ft, Ss, Ss, Gs^Fds, Re, Gs^Fds, Gs^Fds, Gs^Fds, Gs^Fds, Gs^Fds, Ww, Wo, Wo, Wo
Wo, Wo, Ww, Gs, Ww, Gs^Qhh, Gs^Fds, Gs^Fds, Gll^Ftr, Gll^Ftr, Exos, Exos, Gs^Edb, Gs^Ft, Gs^Fds, Gs^Fds, Gs^Ft, Re, Gs^Vht, Gs^Fds, Gs^Fds, Gs^Fds, Gs^Fds, Gs^Ft, Re, Gs^Fds, Re, Re, Re, Gs^Fds, Gs^Ft, Ww, Wo, Wo, Wo
Wo, Wo, Ww, Gs^Ft, Ww, Ww, Gs^Qhh, Gs^Qhh, Gs^Ft, Gs^Ft, Gs^Ft, Exos, Gs, Gs, Gs^Ft, Gs, Ss, Re, Gs^Fds, Gs^Fds, Gs^Fds, Gs^Fds, Gs^Fds, Gs^Fds, Re, Gs^Ft, Gs^Ft, Re, Gg^Vc, Gs^Ft, Ww, Ww, Wo, Wo, Wo
Wo, Wo, Ww, Gs^Ft, Gs^Ft, Ww, Ww, Ww, Ww, Ww, Gs^Ft, Dd, Gs, Gs, Gs, Gs, Gs, Re, Gs^Fds, Gs^Fds, Gs^Fds, Gs^Fds, Gs^Fds, Gs^Fds, Re, Re, Re, Gs^Ft, Gs^Ft, Ww, Ww, Wo, Wo, Wo, Wo
Wo, Wo, Ww, Gs^Ft, Gs, Ww, Wo, Wo, Ww, Ww, Dd, Dd, Dd, Dd, Gs, Dd, Gs, Re, Gs, Gs, Gs, Gs, Gs^Fds, Gs, Gs^Ft, Gs^Ft, Gs^Ft, Ww, Ww, Ww, Wo, Wo, Wo, Wo, Wot
Wo, Wo, Wo, Ww, Ww, Ww, Wo, Wo, Wwr, Ww, Ww, Ww, Dd, Dd, Dd, Dd, Dd, Dd, Gs, Dd, Dd, Ww, Gs, Ww, Gs, Ww, Ww, Ww, Ww, Wo, Wo, Wot, Wot, Wot, Wot
Wo, Wo, Wo, Wo, Ww, Wo, Ww, Wwr, Wwr, Ww, Dd, Dd, Ss, Dd, Ss, Ss, Dd, Dd, Dd, Dd, Dd, Ww, Ww, Ww^_mh, Ww, Ww, Wwt, Wwt, Wwt, Wwt, Wwt, Wot, Wwt, Wot, Wot
Wo, Wo, Wo, Ww, Ww, Ww, Ww, Ww, Ww, Ww, Ww, Dd, Dd, Dd, Dd, Ss, Dd, Dd, Dd, Ww, Ww, Ww, Wo, Wo, Wo, Ww, Wwt, Wwt, Wwt, Dd, Wwt, Wwt, Wwt, Wot, Wot
Wo, Wo, Wo, Ww, Gs, Gs, Gs, Gs, Dd, Ww, Ww, Ww, Ss, Ss, Dd, Ss, Dd, Ww, Ww, Ww, Wwr, Wo, Wo, Wo, Wot, Wwt, Wwt, Dd, Dd, Dd, Dd, Dd, Wwt, Wot, Wot
Wo, Wo, Ww, Ww, Gg^Vc, Gs^Ft, Gs^Ft, Gs^Ft, Dd, Dd, Ss, Ss, Dd, Dd, Dd, Dd, Ww, Ww, Wwr, Ww, Wwr, Wwr, Wo, Wo, Wwt, Wwt, Dd, Gs, Gs^Ft, Gs^Vht, Gs^Ft, Dd, Wwt, Wot, Wot
Wo, Wo, Ww, Ww, Gs, Gs^Ft, Gs^Ft, Gs^Ft, Dd, Ss, Ww, Ss, Ww, Ww, Dd, Dd, Ww, Wwr, Wwr, Wo, Wo, Wo, Wo, Wot, Wwt, Wwt, Dd, Gs, Gs, Gs^Ft, Gs^Ft, Dd, Wwt, Wot, Wot
Wo, Wo, Ww, Gs^Ft, Gs^Ft, Gs^Ft, Gs^Ft, Dd^Vda, Dd, Dd, Ss, Ss, Ww, Ss, Ww, Ww, Wwr, Ww, Wo, Wo, Wo, Wo, Wo, Wot, Wot, Wwt, Wwrt, Wwrt, Dd, Dd, Dd, Wwt, Wot, Wot, Wot
Wo, Wo, Ww, Gs^Ft, Gs^Vht, Gs^Ft, Gs^Ft, Gs^Ft, Dd, Dd, Dd, Dd, Dd, Ss, Dd, Ww, Wo, Wo, Wo, Wo, Wo, Wot, Wot, Wot, Wwt, Wwt, Wwt, Wwrt, Wwrt, Wwt, Wwt, Wwt, Wot, Wot, Wot
Wo, Wo, Ww, Ww, Cvr^Edb, Gs^Ft, Gs^Edb, Ss, Gs, Gs, Dd, Ss, Dd, Dd, Gs, Ww, Wo, Wo, Wo, Wo, Wot, Wot, Wot, Wot, Wwt, Wwt, Wwt, Wwrt, Wwt, Wwt, Wwt, Wwt, Wot, Wot, Wot
Wo, Wo, Wo, Cvr^Edb, Cvr^Edb, Gs^Edb, Gs^Ft, Gs^Edb, Ss, Gs^Ft, Gs, Dd, Dd^Vda, Gs, Gs, Ww, Ww, Ww, Wo, Wo, Wot, Wot, Wot, Wwt, Wwt, Dd^Vda, Wwrt, Wwrt, Wwt, Wwt, Wot, Wot, Wot, Wot, Wot
Wo, Wo, Ww, 3 Kvr, Cvr^Edb, Cvr^Edb, Gs^Ft, Gs^Ft, Ss, Ss, Gs^Ft, Gs, Gs, Gs, Gs^Fds, Gs, Ww, Ww, Wo, Wo, Wot, Wot, Wwt, Wwt, Dd, Dd, Dd, Dd, Wwt, Wot, Wot, Wot, Wot, Wot, Wot
Wo, Wo, Ww, Gs^Ft, Gs, Gs^Ft, Gs^Ft, Gs, Gs^Ft, Gs, Gs, Gs, Gs, Gs^Fds, Gs^Fds, Ww, Ww, Wo, Wot, Wo, Wot, Wwt, Wwt, Ww^Bw\, Dd, Hd, Hd, Md, Wwt, Wwt, Wwt, Wwt, Wwt, Wot, Wot
Wo, Wo, Ww, Dd^Do, Dd, Gs, Gs, Gs, Gs, Gs, Gs, Gs, Gs^Fds, Gs^Fds, Ww, Ww, Wo, Wo, Wot, Wwt, Wwt, Wwt, Wwt, Dd, Md, Mv, Md, Md, Dd, Dd, Wwt, Wwt, Wwt, Wot, Wot
Wo, Wo, Ww, Dd, Gs, Gs, Gs, Gs, Ss, Gs, Gs, Gs^Vht, Gs, Ww, Ww, Wo, Wo, Wo, Wot, Wwt, Wwt, Gs, Gs, Gs^Ft, Hd, Md, Hd, Hd, Gs^Ft, Dd, Dd^Vda, Wwt, Wwt, Wot, Wot
Wo, Wo, Ww, Dd, Gs, Gs, Gs, Ss, Gs, Gs, Gs, Gs, Gs, Ww, Ww, Wo, Wo, Wo, Wo, Wot, Wwt, Wwt, Gs, Hd, Mm, Md, Hd, Gs^Ft, Dd, Wwrt, Wwt, Wwt, Wot, Wot, Wot
Wo, Wo, Ww, Ww, Wwr, Wwr, Gs, Gs, Gs, Gs, Gs, Gs, Wwr, Ww, Wo, Wo, Wo, Wo, Wwr, Wot, Wot, Wwt, Wwt, Gs, Gs, Gs^Vht, Gs, Dd, Wwrt, Wwrt, Wot, Wot, Wot, Wot, Wot
Wo, Wo, Wo, Ww, Ww, Wwr, Gs, Gs^Vht, Gs, Gs, Gs, Gs, Wwr, Ww, Wo, Wwr, Wwr, Wwr, Wwr, Wwr, Wwr, Wot, Wwt, Wwt, Gs, Ss, Gs, Wwrt, Wwrt, Wwrt, Wwrt, Wot, Wot, Wot, Wot
Wo, Wo, Wo, Wo, Ww, Wwr, Wwr, Gs, Ww, Gs, Wwr, Wwr, Wwr, Ww, Wwr, Wwr, Wo, Wo, Wo, Wo, Wot, Wot, Wwt, Wwt, Gs, Wwt, Wwt, Wwt, Wot, Wot, Wot, Wot, Wot, Wot, Wot
Wo, Wo, Wo, Wo, Wo, Ww, Ww, Ww, Ww, Ww, Ww, Wwr, Ww, Wwr, Wwr, Wwr, Wo, Wo, Wo, Wo, Wot, Wot, Wwt, Wwt, Wwt, Wwt, Wwt, Wot, Wot, Wot, Wot, Wot, Wot, Wot, Wot
Wo, Wo, Wo, Wo, Wo, Wo, Wo, Ww, Wo, Ww, Wo, Wo, Wo, Wwr, Wo, Wo, Wo, Wo, Wot, Wot, Wot, Wot, Wot, Wwt, Wot, Wwt, Wot, Wot, Wot, Wot, Wot, Wot, Wot, Wot, Wot
Wo, Wo, Wo, Wo, Wo, Wo, Wo, Wo, Wo, Wo, Wo, Wo, Wo, Wo, Wo, Wo, Wo, Wot, Wot, Wot, Wot, Wot, Wot, Wot, Wot, Wot, Wot, Wot, Wot, Wot, Wot, Wot, Wot, Wot, Wot
