Gs, Gs, Gs, Gg, Gs^Fds, Gg, Gg, Gg, Ss, Ss, Hh^Fds, Hh, Gs^Fds, Gs^Fds, Gll^Fp, Gs^Fds, Ss, Gs^Fds, Gs^Fms, Gg, Rd, Rd, Rd, Gs^Fds, Gs^Fds, Gg, Gs^Fds, Gs^Fds, Gs^Fds, Gs^Fds, Gll^Fp, Gs^Fds, Gs^Fds, Gg, Gs^Fds, Gs^Fds, Gs^Fms
Gs, Gg, Gg, Gg, Gs^Fds, Gg, Gs^Vc, Gg, Ss, Ss, Hh^Fds, Hh^Fds, Gs^Fms, Gs^Fds, Gll^Fp, Gs^Fds, Ss, Gs^Fms, Gs^Fms, Gg^Vc, Rd, Hh, Hh, Gs^Fms, Gs^Fms, Gg, Gs^Fds, Gs^Fds, Gs^Fms, Gs^Fms, Gs^Fds, Gll^Fp, Gs^Fds, Gg, Gll^Fp, Gs^Fms, Gs^Fds
Rd, Gs, Rd, Gg, Gs^Fds, Gs^Fds, Gs^Fds, Gg, Gs^Vc, Hh, Mm, Hh^Fds, Gs^Fds, Gs^Fds, Gll^Fp, Gll^Fp, Gll^Fp, Gs^Fms, Gll^Fp, Gs^Fms, Rd, Hhd^Qhux, Hh, Gs^Fds, Gs, Gs^Fds, Gs^Fds, Gs^Fms, Gs^Fds, Gs^Fds, Gs^Fds, Gs^Fds, Gs^Fds, Gs^Fds, Gll^Fp, Gs^Fms, Gs^Fms
Rd, Rd, Rd^Es, Rd, Gs^Fds, Gs^Fds, Gs^Fds, Gg, Hh, Mm, Mm, Hh^Fds, Gs^Fds, Gs^Vc, Gll^Fp, Gll^Fp, Gll^Fp, Gll^Fp, Gs^Fds, Gs^Fms, Hh, Rd, Rd^Es, Gs, Gs, Gs^Fds, Gs^Fds, Gs^Fms, Gs^Fms, Gs^Fds, Gs^Fds, Gg^Vc, Gs^Fds, Ss, Ss, Gs^Fms, Gs^Fms
Gg, Rd, Rd, Hhd^Qhux, Hh, Gs^Fds, Hh, Hh, Hh, Hh, Hh, Hh, Rd, Rd, Gll^Fp, Cte, Cte, Re, Re, Hh, Hhd^Qhux, Hhd^Qhux, Rd, Gs, Gs^Fds, Gs^Fms, Gs^Fms, Gs^Fms, Gs^Fms, Gs^Fds, Gs^Fds, Gs^Fds, Gg, Ss, Ss, Gs^Fms, Gs^Fms
Gs^Fds, Gs^Fds, Gs^Fds, Rd^Es, Rd^Es, Hhd^Qhux, Hh, Hhd^Qhux, Hhd^Qhux, Hh, Rd, Hh, Rd^Es, Gll^Fp, Cte, 5 Kte, Re, Re, Hh, Rd, Rd^Es, Hh, Gs, Gs, Gg, Gs^Fms, Gs^Fms, Gs^Fms, Gll^Fp, Gs^Fms, Gll^Fp, Gs^Fds, Gs^Fds, Gs^Fds, Gs^Fds, Gs^Fds, Gs^Fds
Gg, Gg, Gs^Fds, Gg, Rd, Rd, Gg, Rd, Rd, Hhd^Qhux, Hh, Rd^Es, Hh, Rd^Es, Rd, Cte, Re, Re, Rd, Hhd^Qhux, Hh, Rd^Es, Rd, Gs, Gg^Vc, Gs^Fds, Gs^Fds, Gs^Fds, Gll^Fp, Gll^Fp, Gll^Fp, Gs^Fms, Gs^Fms, Gs^Fds, Gs^Fds, Gg^Vc, Gg
Gs^Fds, Gs^Fds, Gs^Fds, Gg, Gg, Gg, Gg, Gg, Hh, Hh, Hh, Hh, Hhd^Qhux, Hh, Rd^Es, Rd, Gs^Fds, Gs^Vc, Rd, Hhd^Qhux, Hh, Hh, Gs, Gs, Gg, Gg, Gg, Gs^Fds, Gll^Fp, Gll^Fp, Gll^Fp, Gll^Fp, Gs^Fms, Gs^Fms, Gs^Fds, Gs^Fds, Gs^Fds
Gs^Fds, Gs^Fds, Gs^Fds, Gs^Fds, Gs^Fds, Gg^Vc, Gs^Fds, Hh, Hh, Hh, Hh, Hh, Hh, Hhd^Qhux, Hhd^Qhux, Rd^Es, Gs^Fds, Gs^Fds, Gs, Rd, Gs, Rd, Gs^Fds, Gs^Fds, Gs^Fds, Gg, Gg, Gs^Fds, Gg, Gll^Fp, Gg, Gs^Fds, Gs^Fds, Gs^Fds, Gs^Fds, Gs^Fds, Gs^Fds
Gs^Fds, Gs^Fds, Gs^Fds, Gs^Fds, Gs^Fds, Gs^Fds, Ss, Hh, Gs, Gs, Hh, Ss, Gs^Em, Rd, Gs, Rd, Hhd^Qhux, Gs^Fds, Hh, Hhd^Qhux, Hh, Gs^Fds, Gs^Fds, Gs^Fds, Gs^Fds, Re, Re^Ecf, Gg, Gg, Gg, Gg, Gg, Ss, Gs^Fds, Gs^Fds, Gs^Fds, Gs^Fds
Gs^Fds, Gs^Fds, Gs^Fds, Gg, Gs^Fds, Gs^Fds, Ss, Ss, Gs^Em, Gs, Gs^Em, Gs, Gg^Vc, Gs, Gs^Emf, Rd, Rd, Hh, Rd, Rd, Hh, Hh, Gs, Gs^Fds, Gs^Fds, Re, Re, Gg, Gg, Gg, Gg, Gg^Vc, Ss, Ss, Gs^Fms, Gs^Fds, Gs^Fds
Gs^Fds, Gs^Fds, Gs^Fds, Gs^Fds, Gs^Fds, Gg^Vc, Gs^Fds, Gll, Ss, Ss, Gs^Emf, Gs, Gs^Em, Gs^Em, Ss, Gs^Em, Hh, Hh, Rd, Hhd^Qhux, Rd, Gs, Gs, Gs^Fds, Gg, Gg, Re, Re, Re, Gg, Gg, Gs^Fds, Gs^Fds, Gs^Fds, Gs^Fms, Gg, Gg
Hh^Fds, Gs^Fds, Gs^Fds, Gg, Hh^Fds, Hh^Fds, Hh^Fds, Hh, Ss, Ss, Hh, Ss, Hh, Rd, Rd, Gs, Rd, Rd, Hhd^Qhux, Rd^Es, Rd, Gs, Gg, Gg, Gg, Re, Ce, Ce, Ce, Gg, Gg, Gs^Fds, Gs^Fds, Gll^Fp, Gs^Fms, Gs^Fds, Gs^Fds
Hh, Hh^Fds, Hh, Hh, Hh^Fds, Hh^Fds, Hh, Mm, Mm, Hh, Mm, Hh, Rd, Rd, Rd, Rd, Hh, Rd, Hhd^Qhux, Rd^Es, Gs, Gs, Gs, Gg^Vc, Gg, Re, Ce, 4 Ke, Ce, Re, Gs^Fds, Gs^Fms, Gs^Fms, Gll^Fp, Gs^Fp, Gs^Fms, Gs^Fds
Hh, Hh, Mm, Mm, Mm, Mm, Hh, Mm, Mm, Mm, Mm, Hh, Hh, Hh, Hh, Hh, Hh, Hh, Hh, Hh, Rd, Rd, Rd, Gs, Re, Gg, Re, Re, Gg, Re, Gs^Fms, Gs^Fms, Gs^Fp, Gs^Fms, Gs^Fp, Gs^Fms, Gs^Fms
Hh, Hh, Hh^Fp, Mm, Hh, Hh, Gg^Ve, Hh, Hh, Mm, Mm, Mm, Hh, Hh, Rd, Rd, Hh, Gs, Hh^Qhux, Hh, Gs, Rd, Rd, Rd, Rd, Re, Re, Re, Gg, Gg, Gg, Gs^Fms, Gs^Fp, Gs^Fp, Gg, Gg, Gg
Gs^Fms, Gs^Fms, Hh^Fp, Hh, Gs^Fms, Hh, Gs^Fms, Gs^Fms, Hh^Fp, Mm, Mm, Hh, Hh^Fms, Rd, Gs^Fms, Rd, Gs, Gs, Hh^Qhux, Gs, Gs, Hh, Ss, Ss, Gg, Re, Re, Gg, Gg, Gg, Gg, Gg, Gg, Gg, Gg, Gg^Vc, Gg
Gs^Fms, Gs^Fms, Gs^Fp, Gs^Fms, Gs^Fp, Gs^Fms, Gs^Fp, Hh^Fp, Hh^Fp, Mm, Mm, Gs^Fp, Gs^Fp, Gs^Fms, Gs^Fp, Gs, Rd, Gs, Rd, Rd^Es, Hh, Hh, Rd, Ss, Gg, Re^Ecf, Gs, Gs, Gg, Gg^Vc, Gs^Fds, Gg, Gg, Gg, Gg, Gg, Gg
Gs^Fms, Gs^Fms, Gs^Fms, Gs^Fp, Gs^Fms, Gs^Fp, Gs^Fms, Gs^Fms, Gs^Fms, Hh, Hh, Hh^Fms, Gs^Fms, Gs^Fp, Gg, Gs, Gs, Rd, Rd, Hhd^Qhux, Hhd^Qhux, Hh, Rd, Gs, Rd, Gg, Gs, Gs, Gg, Gs^Fds, Gs^Fds, Gg, Gg, Gg, Gg, Gg, Gg
Gg, Gs^Fms, Gg, Gs^Fms, Gg, Gs^Fms, Gs^Fms, Gs^Fms, Gs^Fms, Hh, Gs^Fms, Gs^Fms, Gg^Vc, Gs^Fms, Gs, Gs, Hh, Hhd^Qhux, Gs, Rd, Hh, Hhd^Qhux, Hhd^Qhux, Hh, Rd, Gs, Gs, Gs, Gg, Hh, Gg, Gg, Gg, Gs^Fds, Gg, Gg, Gg
Gg, Gs^Fms, Gg, Gg, Ce, Ce, Ce, Gs^Fms, Gg, Gs^Fms, Gs^Fms, Gs^Fms, Gg, Gg, Gs, Gs, Rd^Es, Hhd^Qhux, Gs, Rd, Hh, Hh, Rd^Es, Rd^Es, Hh^Qhux, Hh, Rd^Es, Gs, Hh, Hh, Hh, Gg, Gg, Gg, Gg, Gg, Gg
Re, Gg, Re, Gg, Ce, 3 Ke, Re, Re, Gg, Gg, Ss, Gg, Gg, Gg, Rd, Rd^Es, Hhd^Qhux, Rd, Gs, Gs, Gs, Ss, Gs, Rd^Es, Rd, Hh^Qhux, Rd^Es, Rd^Es, Hh, Hh, Hh, Gg, Gg, Gg, Gg, Gg, Hh
Gg, Re, Gg, Re, Re, Ce, Re, Gg, Gg, Gg, Gg, Gg, Gg, Hh, Hhd^Qhux, Hhd^Qhux, Hh, Gs, Gs, Gs, Gs, Gg, Gg, Gs, Gg^Vc, Gs, Rd, Hhd^Qhux, Hhd^Qhux, Hhd^Qhux, Hhd^Qhux, Hh, Hh, Gg, Hh, Hh, Hh
Hh, Gg, Gg^Vc, Re, Re, Re, Gg, Gg, Gg, Gg, Gs, Gs, Hh, Hh, Rd^Es, Hh, Gg, Gg, Gs^Fds, Gg, Gg, Gg, Gg, Gg, Gs, Gs, Hh, Hh, Hh, Rd, Rd^Es, Hhd^Qhux, Hh, Hhd^Qhux, Hhd^Qhux, Hhd^Qhux, Hhd^Qhux
Hh, Gg, Gg, Gg, Re^Ecf, Re, Gg, Gg, Gs, Gg^Vc, Gg, Gs, Hh, Hhd^Qhux, Rd^Es, Gs, Gg, Gg, Gs^Fds, Gs^Fds, Gg, Gg, Gg, Gg, Gg, Gg, Gg, Hh, Gg, Gs, Gs, Rd^Es, Rd, Rd^Es, Hh, Hh, Hh
Hh, Gg, Gg, Gg, Gg, Gg, Gg, Gs^Fds, Re^Ecf, Gs, Gg, Rd^Es, Rd^Es, Hhd^Qhux, Gs, Gs, Gg, Gg, Gs^Fds, Gs^Fds, Gg, Gg, Gg, Gg, Gg, Gg, Gg, Hh, Gg, Gs, Gg, Gs, Gg^Vc, Hh, Gs^Fds, Hh, Hh
Hh, Hh, Hh, Gg, Hh, Gs^Fds, Gs^Fds, Gs^Fds, Gs^Fds, Gs, Rd, Rd^Es, Hhd^Qhux, Hh, Gs, Gs, Gg, Gg, Ss^Vhs, Ss, Gg, Gg, Gg, Gg, Gg, Gs^Fds, Gs^Fds, Gg, Gg, Gs, Gg, Gg, Gs^Fds, Gs^Fds, Gs^Fds, Gs^Fds, Gs^Fds
Hh, Hh, Hh, Hh, Mm, Gs^Fds, Gs^Fds, Gs^Fds, Gs^Fds, Gs, Rd, Hhd^Qhux, Hh, Hh, Gs, Gs, Ww, Ww, Ww, Ss, Gg, Gg, Gg, Gg, Gg, Gs^Fds, Gs^Fds, Gg, Gg, Gg, Gg, Gs^Fds, Gg, Gs^Fds, Gg^Vc, Gs^Fds, Gs^Fds
Hh, Hh, Hh, Gg^Ve, Mm, Hh, Ss, Gs^Fds, Ss, Gs, Hh, Hhd^Qhux, Rd, Gs, Gg, Ww, Ww, Wo, Ww, Gg, Hh, Hh, Mm, Gg, Gg, Gs^Fds, Gs^Fds, Gg, Gs^Fds, Gg, Gg, Gg, Gg, Ss, Gg, Gs^Fds, Gs^Fds
Hh, Hh, Hh, Mm, Mm, Gs^Fds, Ss, Ss, Ss, Hh, Hhd^Qhux, Rd, Gs, Gs, Gs, Gg, Ww, Wo, Wo, Gg, Gg, Mm, Mm, Gg^Ve, Gg, Gg, Gs^Fds, Gs^Fds, Gs^Fds, Gg, Gg, Gg^Vc, Gg, Gg, Ss, Gg, Ss
Hh, Hh, Gs^Fds, Hh, Gs^Fds, Gs^Fds, Gs^Fds, Gs^Fds, Hh, Hh, Hhd^Qhux, Rd, Gs, Gs, Gs^Fds, Gs^Fds, Ww, Ww, Ww, Ww, Gg, Hh, Mm, Mm, Gg, Gg, Gg, Gg, Gg, Gg, Gg, Gg, Gg, Ss, Ss, Gg, Ss
Gg, Gs^Fds, Gs^Fds, Gs^Fds, Gs^Fds, Gs^Fds, Gs^Fds, Gs^Fds, Rd^Es, Rd^Es, Rd, Hh, Gs^Fds, Gs^Fms, Gs^Fms, Gs^Fds, Gs^Fms, Hh, Gg^Ve, Wwr, Hh, Hh, Mm, Hh, Gg, Gg, Gs^Fds, Gg, Gg, Gg, Gg, Gg, Gg, Gg, Gg, Gg, Gg
Gs^Fds, Gs^Fds, Gg^Vc, Gs^Fds, Gs^Fds, Gs, Rd, Gs, Hhd^Qhux, Hhd^Qhux, Rd^Es, Hh, Gs, Gs^Fds, Gs^Fms, Gs^Fp, Hh^Fp, Hh, Mm, Ww, Hh, Mm, Mm, Mm, Hh, Gg^Vc, Gs^Fds, Gg, Gg, Gg, Gg, Gg, Ce, Gg, 2 Gg, Gg, Gg
Gs^Fds, Gs^Fds, Gs^Fds, Gs^Fds, Gs^Fds, Gs, Rd, Rd^Es, Hh, Hh, Gs, Rd, Gs, Gs^Fms, Gs^Fms, Gs^Fp, Hh, Mm, Mm, Ww, Ww, Hh, Hh, Mm, Hh, Hh^Fds, Hh^Fds, Gs^Fds, Gg, Gg, Gg, Ce, 1 Ke, Ce, Gg, Gg, Gg
Hh, Hh, Gs^Fds, Gs^Fds, Hh, Hh, Rd, Hhd^Qhux, Rd^Es, Gs, Gs, Gs, Gs, Gs^Fds, Gg^Vc, Hh^Fms, Mm, Mm, Hh, Wwr, Gs^Fms, Ww, Hh^Vc, Hh, Mm, Hh^Fds, Hh^Fds, Gs^Fds, Gs^Fds, Hh, Hh, Ce, Ce, Ce, Gg, Gg, Gg
Hh, Hh, Gs^Fds, Gs^Fds, Hh, Hh, Hh, Hhd^Qhux, Rd^Es, Gs, Gs, Gs, Gs, Gg, Gg, Hh, Mm, Mm, Hh^Fms, Gs^Fms, Gs^Fms, Ww, Wwr, Hh, Mm, Mm, Hh, Gs^Fds, Gs^Fds, Gs^Fds, Hh, Hh, Hh, Hh, Gg, Gg, Gg
Hh, Hh, Gs^Fds, Gs^Fds, Hh, Hh, Hh, Hhd^Qhux, Gs, Rd, Gg, Gs, Gg, Gg, Gg, Hh, Mm, Mm, Hh^Fms, Gs^Fp, Gs^Fp, Ww, Gg, Hh, Mm, Mm, Hh, Gs^Fds, Gs^Fds, Gs^Fds, Hh, Hh, Hh, Hh, Gg, Gg, Gg
