Gg, Gg, Gg, Gg, Gs^Fds, Gg, Gg, Gg, Ss^Qhu, Ss^Qhu, Hh^Fds, Hh, Gs^Fds, Gs^Fds, Gs^Fds, Gs^Fds, Ss, Gs^Fds, Gs^Fds, Gg, Gg, Gg, Re, Gs^Fds, Gs^Fds, Gg, Gs^Fds, Gs^Fds, Gs^Fds, Gs^Fds, Gs^Fds, Gs^Fds, Gs^Fds, Gg, Gs^Fds, Gs^Fds, Gs^Fds
Gg, Gg, Gg, Gg, Gs^Fds, Gg, Gg^Vc, Gg, Ss^Qhu, Ss^Qhu, Hh^Fds, Hh^Fds, Gs^Fds, Gs^Fds, Gs^Fds, Gs^Fds, Ss, Gs^Fds, Gs^Fds, Gg^Vc, Gg, Gg, Re, Gs^Fds, Gs^Fds, Gg, Gs^Fds, Gs^Fds, Gs^Fds, Gs^Fds, Gs^Fds, Gs^Fds, Gs^Fds, Gg, Gs^Fds, Gs^Fds, Gs^Fds
Gg, Gg, Gg, Gg, Gs^Fds, Gs^Fds, Gs^Fds, Gg, Gg^Vc, Hh, Mm, Hh^Fds, Gs^Fds, Gs^Fds, Gs^Fds, Gs^Fds, Gs^Fds, Gs^Fds, Gs^Fds, Gs^Fds, Gg, Uhe^Qhux, Re, Gs^Fds, Gg, Gs^Fds, Gs^Fds, Gs^Fds, Gs^Fds, Gs^Fds, Gs^Fds, Gs^Fds, Gs^Fds, Gs^Fds, Gs^Fds, Gs^Fds, Gs^Fds
Gg, Gg, Rd, Gg, Gs^Fds, Gs^Fds, Gs^Fds, Gg, Hh, Mm, Mm, Hh^Fds, Gs^Fds, Gg^Vc, Gs^Fds, Gs^Fds, Gs^Fds, Gs^Fds, Gs^Fds, Gs^Fds, Re, Re, Gg, Gg, Gg, Gs^Fds, Gs^Fds, Gs^Fms, Gs^Fms, Gs^Fds, Gs^Fds, Gg^Vc, Gs^Fds, Ss, Ss, Gs^Fds, Gs^Fds
Gg, Gg, Gg, Uhe^Qhux, Gg, Gs^Fds, Gg, Gg, Rd, Hh, Hh, Hh, Gs, Gs, Gs^Fds, Cte, Cte, Rb^Edt, Re, Re, Uhe^Qhux, Uhe^Qhux, Gg, Gg, Gs^Fds, Gs^Fds, Gs^Fds, Gs^Fms, Gs^Fms, Gs^Fms, Gs^Fms, Gs^Fms, Gg, Ss, Ss, Gs^Fds, Gs^Fds
Gs^Fds, Gs^Fds, Gs^Fds, Gg, Rd, Uhe^Qhux, Rd, Uhe^Qhux, Uhe^Qhux, Rd, Rd, Hh, Re, Gs^Fds, Cte, 5 Kte, Rb^Edt, Rb^Edt, Gd, Re, Rd, Gs, Gs, Gg, Gg, Gs^Fds, Gs^Fds, Gs^Fms, Gs^Fms, Gs^Fms, Gs^Fds, Gs^Fds, Gs^Fds, Gs^Fds, Gs^Fds, Gs^Fds, Gs^Fds
Gg, Gg, Gs^Fds, Gg, Gg, Rd, Gg, Rd, Gg, Uhe^Qhux, Rd, Re, Rb^Edt, Rb, Rb^Edt, Cte, Rb, Re, Gd, Uhe^Qhux, Rd, Re, Re, Gs, Gg^Vc, Gs^Fds, Gs^Fds, Gs^Fds, Gs^Fds, Gs^Fms, Gs^Fds, Gs^Fms, Gs^Fds, Gs^Fds, Gs^Fds, Gg^Vc, Gg
Gs^Fds, Gs^Fds, Gs^Fds, Gg, Gg, Gg, Gg, Gg, Gg, Gg, Gs, Rd, Uhe^Qhux, Re, Re^Edt, Rb^Edt, Gs^Fds, Gd^Vc, Rd, Uhe^Qhux, Rd, Rd, Gs, Re, Re, Gg, Gg, Gs^Fds, Gs^Fds, Gs^Fds, Gs^Fds, Gs^Fds, Gs^Fds, Gs^Fds, Gs^Fds, Gs^Fds, Gs^Fds
Gs^Fds, Gs^Fds, Gs^Fds, Gs^Fds, Gs^Fds, Gg^Vc, Gs^Fds, Gg, Gg, Gg, Gs, Gs, Rd, Uhe^Qhux, Uhe^Qhux, Re, Gs^Fds, Gs^Fds, Rd, Rd, Rd, Gs, Gs^Fds, Gs^Fds, Gs^Fds, Re, Gg, Gs^Fds, Gg, Gs^Fds, Gg, Gs^Fds, Gs^Fds, Gs^Fds, Gs^Fds, Gs^Fds, Gs^Fds
Gs^Fds, Gs^Fds, Gs^Fds, Gs^Fds, Gs^Fds, Gs^Fds, Ss, Gg, Gg, Gs, Gs, Gs, Rd, Rd, Gg, Gg, Uhe^Qhux, Gs^Fds, Rd, Uhe^Qhux, Rd, Gs^Fds, Gs^Fds, Gs^Fds, Gs^Fds, Re, Re^Ecf, Gg, Gg, Gg, Gg, Gg, Ss, Gs^Fds, Gs^Fds, Gs^Fds, Gs^Fds
Gs^Fds, Gs^Fds, Gs^Fds, Gg, Gs^Fds, Gs^Fds, Ss, Ss, Gg, Gg, Gs, Gg, Gg^Vc, Gg, Gg, Gg, Gs, Gs, Gs, Gs, Gg, Gg, Gg, Gs^Fds, Gs^Fds, Re, Re, Gg, Gg, Gg, Gg, Gg^Vc, Ss, Ss, Gs^Fds, Gs^Fds, Gs^Fds
Gs^Fds, Gs^Fds, Gs^Fds, Gs^Fds, Gs^Fds, Gg^Vc, Gs^Fds, Gg, Gg, Gg, Gg, Gg, Gg, Gg, Ss, Gg, Gs, Gg, Rd, Uhe^Qhux, Gg, Gg, Gg, Gs^Fds, Gg, Gg, Re, Gg, Gg, Gg, Gg, Gs^Fds, Gs^Fds, Gs^Fms, Gs^Fms, Gg, Gg
Hh^Fds, Gs^Fds, Gs^Fds, Gg, Hh^Fds, Hh^Fds, Hh^Fds, Hh, Gg, Gg, Gs, Gg, Gs, Gg, Gs, Gs, Gs, Rd, Uhe^Qhux, Gg, Gg, Gg, Gg, Gg, Gg, Gg^Edt, Ce, Ce, Ce^Edt, Gg, Gg, Gs^Fds, Gs^Fds, Gs^Fms, Gs^Fms, Gs^Fds, Gs^Fds
Hh, Hh^Fds, Hh, Hh, Hh^Fds, Hh^Fds, Hh, Mm, Mm, Hh, Mm, Gs, Gs, Gs, Gs, Gs, Gs, Rd, Uhe^Qhux, Gg, Gg, Gg, Gg, Gg^Vc, Gg, Gg, Ce^Edt, 4 Ke, Ce, Gg, Gs^Fds, Gs^Fms, Gs^Fms, Gs^Fms, Gs^Fp, Gs^Fms, Gs^Fds
Hh, Hh, Mm, Mm, Mm, Mm, Hh, Mm, Mm, Mm, Mm, Hh, Hh, Gs, Gs, Gs, Gs, Rd, Rd, Gg, Gs, Gs, Gs, Gs, Gs, Gg, Gg^Edt, Re^Edt, Gg, Gg, Gs^Fms, Gs^Fms, Gs^Fp, Gs^Fms, Gs^Fp, Gs^Fms, Gs^Fms
Hh, Hh, Hh^Fp, Mm, Hh, Hh, Gs^Ve, Hh, Hh, Mm, Mm, Mm, Hh, Hh, Gs, Gs, Gs, Gs, Uhe^Qhux, Gg, Gs, Gs, Rd, Re, Re, Gg, Gg, Re, Gg, Gg, Gg, Gs^Fms, Gs^Fp, Gs^Fp, Gg, Gg, Gg
Gg, Gg, Hh^Fp, Hh, Gs, Hh, Gs, Gs, Hh^Fp, Mm, Mm, Hh, Hh^Fms, Gs, Gs^Fms, Gs, Gs, Gs, Uhe^Qhux, Gs, Rd, Rd, Ss, Ss, Gs, Re, Re, Re, Gg, Gg, Gg, Gg, Gg, Gg, Gg, Gg^Vc, Gg
Gg, Gg, Gs^Fp, Gs, Gs^Fp, Gs, Gs^Fp, Hh^Fp, Hh^Fp, Mm, Mm, Gs^Fp, Gs^Fp, Gs^Fms, Gs^Fp, Gs, Gs, Rd, Rd, Rd, Rd, Rd, Gs, Ss, Gs, Re^Ecf, Gg, Gg, Gg, Gg^Vc, Gs^Fds, Gg, Gg, Gg, Gg, Gg, Gg
Gg, Gg, Gg, Gs^Fp, Gs^Fms, Gs^Fp, Gs^Fms, Gs, Gs, Hh, Hh, Hh^Fms, Gs^Fms, Gs^Fp, Gs, Gs, Rd, Rd, Rd, Uhe^Qhux, Uhe^Qhux, Rd, Gs, Gs, Gs, Gg, Gg, Gg, Gg, Gs^Fds, Gs^Fds, Gg, Gg, Gg, Gg, Gg, Gg
Gg, Gg, Gg, Gs^Fms, Gg, Gs^Fms, Gs, Gs, Gs, Hh, Gg, Gg, Gg^Vc, Gs^Fms, Re, Re, Gg, Uhe^Qhux, Gs, Gs, Gs, Uhe^Qhux, Uhe^Qhux, Gs, Rd, Gg, Gg, Gg, Gg, Gg, Gg, Gg, Gg, Gs^Fds, Gg, Gg, Gg
Gg, Gg, Gg, Gg, Ce, Ce, Ce, Gs, Gs, Gg, Re, Gg, Re, Re, Gg, Gg, Gg, Uhe^Qhux, Gs, Gs, Gs, Rd, Rd, Rd, Uhe^Qhux, Gg, Gs, Gg, Gg, Gg, Gg, Gg, Gg, Gg, Gg, Gg, Gg
Re, Re, Re^Edt, Re, Ce, 3 Ke, Re^Edt, Re^Edt, Re, Re, Ss, Re, Gg, Gg, Rd, Gg, Uhe^Qhux, Rd, Gs, Gs, Gg, Ss, Gg, Rd, Gs, Uhe^Qhux, Gs, Gg, Gg, Gg, Gg, Gg, Gg, Gg, Gg, Gg, Gg
Gg, Gg, Gg, Gg, Gg, Ce, Re^Edt, Re^Edt, Gg, Gg, Gg, Gg, Rd, Rd, Uhe^Qhux, Uhe^Qhux, Rd, Rd, Rd, Gs, Gg, Gg, Gs, Gs, Gg^Vc, Gs, Gs, Uhe^Qhux, Uhe^Qhux, Uhe^Qhux, Uhe^Qhux, Rd, Rd, Gg, Gg, Gg, Gg
Gg, Gg, Gg^Vc, Gg, Gg, Gg, Gg, Re^Edt, Gg, Gg, Gg, Gg, Rd, Rd, Gg, Gg, Gg, Gg, Gs^Fds, Gg, Gg, Gg, Gs, Gs, Gs, Gs, Gs, Rd, Rd, Rd, Gg, Uhe^Qhux, Rd, Uhe^Qhux, Uhe^Qhux, Uhe^Qhux, Uhe^Qhux
Gg, Gg, Gg, Gg, Re^Ecf, Gg, Gg, Re, Re, Gg^Vc, Gg, Gg, Gg, Uhe^Qhux, Gg, Gg, Gg, Gg, Gs^Fds, Gs^Fds, Gg, Gg, Gg, Gs, Gg, Gs, Gg, Gs, Gg, Gg, Gg, Gg, Gg, Gg, Gg, Gg, Gg
Gg, Gg, Gg, Gg, Gg, Gg, Gg, Gs^Fds, Re^Ecf, Gg, Gg, Gg, Gg, Uhe^Qhux, Gg, Gg, Gg, Gg, Gs^Fds, Gs^Fds, Gg, Gg, Gg, Gg, Gg, Gg, Gg, Gg, Gg, Gg, Gg, Gg, Gg^Vc, Gg, Gll^Fp, Gg, Gg
Gg, Gg, Gg, Gg, Hh, Gg, Gg, Gs^Fds, Gs^Fds, Gg, Gs, Gg, Uhe^Qhux, Rd, Gg, Gg, Gg, Gg, Ss^Vhs, Ss, Gg, Gg, Gg, Gg, Gg, Gs^Fds, Gs^Fds, Gg, Gg, Gg, Gg, Gg, Gs^Fds, Gs^Fds, Gll^Fp, Gs^Fds, Gs^Fds
Gg, Gg, Gg, Hh, Mm, Gg, Gs, Gs^Fds, Gs^Fds, Gs, Gs, Uhe^Qhux, Rd, Rd, Gg, Gg, Gs, Gg, Gs, Ss, Gg, Gg, Gg, Gg, Gg, Gll^Fp, Gll^Fp, Gg, Gg, Gg, Gg, Gs^Fds, Gg, Gll^Fp, Gg^Vc, Gll^Fp, Gs^Fds
Gg, Gg, Gg, Gg^Ve, Mm, Hh, Ss, Gs, Ss, Gs, Gs, Uhe^Qhux, Rd, Gg, Gg, Gg, Gs, Gs, Gs, Gs, Hh, Hh, Mm, Gg, Gg, Gs^Fds, Gll^Fp, Gg, Gs^Fds, Gg, Gg, Gg, Gg, Gg, Gg, Gs^Fds, Gs^Fds
Gg, Gg, Hh, Mm, Mm, Gs, Ss, Ss, Ss, Gs, Uhe^Qhux, Gg, Gg, Gg, Gg, Gg, Gg, Gs, Gs, Gs, Gs, Mm, Mm, Gg^Ve, Gs, Gg, Gs^Fds, Gs^Fms, Gs^Fds, Gg, Gg, Gg^Vc, Gg, Gg, Ss, Gg, Gg
Gg, Gg, Gg, Hh, Gs, Gs, Gs, Gs, Rd, Gs, Uhe^Qhux, Gg, Gg, Gg, Gs^Fds, Gs^Fds, Gs, Gs, Gs, Gs, Gs, Hh, Mm, Mm, Gs, Gs, Gs, Gs, Gs, Gg, Gs, Gg, Gg, Ss, Ss, Gg, Gg
Gg, Gg, Gg, Gs, Gs, Gs, Gs, Gs, Rd, Rd, Gg, Gg, Gs^Fds, Gs^Fms, Gs^Fms, Gs^Fds, Gs^Fms, Hh, Gg^Ve, Gs, Hh, Hh, Mm, Hh, Gs, Gs, Gs^Fds, Gs, Gs, Gs, Gs, Gg, Gg, Gg, Gg, Gg, Gg
Gg, Gg, Gg^Vc, Gs, Gs^Fds, Gs, Gs, Rd, Uhe^Qhux, Uhe^Qhux, Gg, Gg, Gg, Gs^Fds, Gs^Fms, Gs^Fp, Hh^Fp, Hh, Mm, Gs, Hh, Mm, Mm, Mm, Hh, Gg^Vc, Gs^Fds, Gs, Gs, Gs, Gg, Gg, Ce, Gg, 2 Gg, Gg, Gg
Gs^Fds, Gs^Fds, Gs^Fds, Gs^Fds, Gs^Fds, Gs, Gs, Rd, Rd, Gg, Gg, Gg, Gg, Gs^Fms, Gs^Fms, Gs^Fp, Hh, Mm, Mm, Gs, Gs, Hh, Hh, Mm, Hh, Hh^Fds, Hh^Fds, Gs^Fds, Gs, Gs, Gg, Ce, 1 Ke, Ce, Gg, Gg, Gg
Gg, Gg, Gs^Fds, Gs^Fds, Gg, Gs, Rd, Uhe^Qhux, Rd, Gg, Gg, Gg, Gg, Gs^Fds, Gg^Vc, Hh^Fms, Mm, Mm, Hh, Gs, Gs^Fms, Gs, Gg^Vc, Hh, Mm, Hh^Fds, Hh^Fds, Gs^Fds, Gs^Fds, Gg, Gg, Ce, Ce, Ce, Gg, Gg, Gg
Gg, Gg, Gs^Fds, Gs^Fds, Gg, Gg, Gg, Uhe^Qhux, Rd, Gg, Gg, Gg, Gg, Gg, Gg, Hh, Mm, Mm, Hh^Fms, Gs^Fms, Gs^Fms, Gs, Gs, Hh, Mm, Mm, Gg, Gs^Fds, Gs^Fds, Gs^Fds, Gg, Gg, Gg, Gg, Gg, Gg, Gg
Gg, Gg, Gs^Fds, Gs^Fds, Gg, Gg, Gg, Uhe^Qhux, Gg, Gg, Gg, Gg, Gg, Gg, Gg, Hh, Mm, Mm, Hh^Fms, Gs^Fp, Gs^Fp, Gs, Gg, Hh, Mm, Mm, Gg, Gs^Fds, Gs^Fds, Gs^Fds, Gg, Gg, Gg, Gg, Gg, Gg, Gg
