Gg, Gg, Gs^Fds, Gs^Fds, Gs^Fds, Gg, Gg, Gg, Gs^Fds, Gs^Fds, Gs^Fds, Gs^Fds, Gs^Fds, Gg, Gg, Hh, Hh, Mm, Mm, Mm, Mm, Hh^Fds, Hh^Fds, Gg, Gg, Gg, Gg, Gg, Gg, Gg, Gg, Gg, Gs^Fds, Gs^Fds, Gs^Fds, Gg, Gs^Fds, Gg, Gs^Fds, Gg, Gg, Gg
Gg, Gg, Gs^Fds, Gs^Fds, Gs^Fds, Gg, Gg^Vc, Gg, Gs^Fds, Gs^Fds, Gs^Fds, Gs^Fds, Gs^Fds, Gg, Gg, Hh, Hh, Mm, Mm, Mm, Mm, Hh^Fds, Gs^Fds, Gg, Gg, Gg, Gg, Gg, Gg, Gg, Gg, Gg, Gs^Fds, Gs^Fds, Gs^Fds, Gg, Gs^Fds, Gg^Vh, Gs^Fds, Gg, Gg, Gg
Gg, Gg, Gg, Gs^Fds, Gs^Fds, Gs^Fds, Gs^Fds, Gs^Fds, Gs^Fds, Gs^Fds, Gg^Ecf, Gs^Fds, Gg, Gg, Gg, Hh, Hh, Hh, Hh, Hh, Hh, Hh^Fds, Gs^Fds, Gg, Gg, Gg, Gg, Ss, Gg, Gg, Gg, Gs^Fds, Gs^Fds, Gs^Fds, Gs^Fds, Gs^Fds, Gs^Fds, Gs^Fds, Gs^Fds, Gs^Fds, Gg, Gg
Gg, Gg, Gg, Gg, Gg, Gg, Hh^Fds, Gs^Fds, Hh^Fds, Gg, Gg, Gg, Gg, Gg^Vc, Gg, Gg, Gg, Gg^Ve, Hh, Gs^Fds, Gg, Gs^Fds, Gs^Fds, Gg^Vc, Gg, Gg, Gg, Gg, Gg, Gg, Gs^Fds, Gs^Fds, Gs^Fds, Gs^Fds, Gs^Fds, Gs^Fds, Gs^Fds, Gs^Fds, Gg^Vc, Gs^Fds, Gg, Gg
Ds, Ds, Ds, Gg, Gg, Gg, Hh, Hh^Fds, Gg, Gg, Ss, Gg, Gg, Gg, Gg, Gg, Gg, Gg, Gg, Gg, Gg, Gs^Fds, Gs^Fds, Gs^Fds, Gg, Gg, Gg, Gg, Gg, Gs^Fds, Gs^Fds, Gg^Vc, Gg, Gg, Ce, Gs^Fds, Ce, Gs^Fds, Gg, Gg, Gg, Gg
Ww, Ww, Ww, Gg, Gg, Gg, Gg^Vc, Hh, Gg, Gg, Gg, Gg, Ce, Ce, Ce, Gg, Gg, Gg, Gg, Gg, Ss, Gg, Gg, Gg, Gg, Gg, Hh, Hh, Mm, Gg, Gg, Gg, Gg, Gg, Ce, Ce, Ce, Gg, Gg, Gg, Gg, Gg
Ww, Ww, Ww, Ww, Ww, Gg, Gg, Gg, Gg, Gg, Gg, Gg, Ce, 4 Ke, Ce, Gg, Gg, Gg, Gg, Ss, Ss, Gg, Gg, Gg, Gg, Gg, Hh, Mm, Mm, Hh, Hh, Gg, Gg, Gg, Ce, 5 Ke, Ce, Gg, Gg, Gg^Ecf, Gg, Gg
Wo, Wo, Wo, Ww, Ww, Gg, Ds, Ds, Gg, Gg, Gg, Gg, Ce, Ce, Ce, Gg, Gg, Gg, Gg, Gg^Vc, Gs^Fds, Gg, Gg, Gg, Gg, Gg, Hh, Mm, Hh, Hh, Gg, Gg, Gg, Gg, Gg, Ce, Gg, Gg, Gg, Gg, Gg, Gg
Wo, Wo, Wo, Ww, Ww, Ww, Ww, Ds, Gg^Ecf, Gg, Gg, Gg, Gg, Gg, Gg, Gg, Gg, Gg^Ecf, Gg, Gs^Fds, Gs^Fds, Gs^Fds, Gg, Gg, Gg, Gg, Gg, Gg, Gg, Gg^Ecf, Gg, Gg, Gg, Gg, Gg, Gg, Gg, Gg, Gs^Fds, Gg, Gg, Gg
Wo, Wo, Wo, Wo, Wo, Ww, Ww, Ww, Gg, Gg, Gg^Vc, Gg, Gg, Gg, Gg, Gg, Gg, Gg, Gg, Gs^Fds, Gs^Fds, Gs^Fds, Gs^Fds, Gs^Fds, Gg, Gg, Gg, Gg^Vc, Gg, Gg, Gg, Hh, Mm, Gg, Gg, Gg, Gg^Ve, Gs^Fds, Gs^Fds, Gs^Fds, Gs^Fds, Gs^Fds
Wo, Wo, Wo, Wo, Wo, Ww, Ww, Ww, Ds, Gg, Gg, Gg, Gg, Gg, Gg, Ss, Gg, Gg^Vc, Gs^Fds, Gs^Fds, Ss, Gs^Fds, Gs^Fds, Gs^Fds, Gs^Fds, Gg, Gg, Gg, Gg, Gg, Gg, Hh, Hh, Hh, Gs^Fds, Gg, Gg, Gg, Gs^Fds, Gs^Fds, Gs^Fds, Gs^Fds
Wo, Wo, Wo, Wo, Ww, Ww, Ww^Vm, Ww, Ww, Ds, Ds, Ds, Gg, Gg, Gg, Gg, Gs^Fds, Gs^Fds, Gs^Fds, Ss, Ss, Ss, Gs^Fds, Gs^Fds, Gg^Vc, Gg, Gg^Ecf, Gg, Gg, Gg, Ss, Gg^Vc, Gg, Hh^Fds, Hh^Fds, Gg, Gg, Gg, Gg, Ss, Gs^Fds, Gs^Fds
Wo, Wo, Wo, Wo, Ww, Ww, Ww, Ww, Ww, Ww, Ww, Ds, Gg, Gg^Vc, Gg, Gg, Gs^Fds, Gs^Fds, Ss, Ss, Gs^Fds, Gs^Fds, Gs^Fds, Gs^Fds, Gs^Fds, Gg, Gg, Gg, Gg, Ss, Gg, Gs^Fds, Gs^Fds, Hh^Fds, Gs^Fds, Gs^Fds, Gs^Fds, Gs^Fds, Gs^Fds, Gg, Gg, Gg
Wo, Wo, Wo, Wo, Wo, Ww, Ww, Ww, Ww, Ww, Ww, Ww, Ww, Gg, Gg, Gg, Gg, Gs^Fds, Ww, Gs^Fds, Gg, Gg, Gg, Gs^Fds, Gg, Gg, Gg, Gg, Ss, Gg, Gg, Gs^Fds, Gs^Fds, Gs^Fds, Ss, Ss^Vhs, Ss, Gs^Fds, Gs^Fds, Ss, Gg, Gg
Wo, Wo, Wo, Wo, Wo, Ww, Ww, Ww, Wo, Wo, Wo, Ww, Ww, Ds, Gg, Gg, Ww, Ww, Ww, Ww, Ww, Gg, Ww, Gg, Gg, Gg, Ss, Ss, Ss, Ss, Ss, Ss, Ss, Ss, Ss, Ss, Ss, Ss, Gg^Vc, Gs^Fds, Gg, Gg
Wo, Wo, Wo, Wo, Ww, Ww, Ww, Ww, Wo, Wo, Wo, Wo, Ww, Ww, Ww, Ww, Ww, Ww, Gg, Ww, Gg, Ww, Gg, Ww^Bw/, Ww, Ww, Ww, Ss, Ww, Ww, Ww, Ss, Ss, Ss, Ww, Ww, Ss, Ss, Gg, Gg, Ss, Ss
Wo, Wo, Wo, Ww, Ww, Ww, Ww, Wo, Wo, Wo, Wo, Wo, Wo, Wo, Ww, Ww, Gg, Gg, Gg, Gg, Gs^Fds, Gg^Ve, Gg, Ww, Ww, Ww, Ww, Ww, Ss, Ss^Vhs, Ww, Ww, Ss, Ww, Ss, Ww, Ss, Ss, Gs^Fds, Gg, Gs^Fds, Gs^Fds
Wo, Wo, Ww, Ww, Gg, Ww, Ww, Wo, Wo, Wo, Wo, Wo, Wo, Wo, Ww, Gs^Fds, Gs^Fds, Gs^Fds, Gs^Fds, Gg, Gg, Gg, Ww^Bw\, Ww, Gg, Gg, Gg, Ss, Ss, Ss, Ss, Ss, Ss, Ss, Ss, Ss, Ss, Gs^Fds, Gs^Fds, Gg, Gg, Gg
Wo, Wo, Ww, Gg^Vc, Hh, Gg, Gg^Vc, Ww, Ww, Wo, Wo, Wo, Wo, Ww, Ww, Ds, Gs^Fds, Gs^Fds, Ww, Ww, Ww, Gg, Ww, Gg, Gg, Gg, Gs^Fds, Gs^Fds, Gs^Fds, Ss, Gg, Ss, Ss, Gs^Fds, Ss, Gs^Fds, Gs^Fds, Gs^Fds, Gs^Fds, Gg^Vh, Gg, Gg
Wo, Wo, Ww, Gs^Fds, Chr, Gg, Gg, Ds, Ww, Wo, Wo, Wo, Wo, Ww, Wo, Ww, Ww, Ww, Ww, Ww, Ww, Ww, Ww, Gg, Gg, Gs^Fds, Gs^Fds, Ss, Ss, Gs^Fds, Gs^Fds, Gs^Fds, Gs^Fds, Gs^Fds, Gs^Fds, Gg, Gs^Fds, Gs^Fds, Gs^Fds, Gs^Fds, Gg, Gg
Wo, Wo, Ww, Ds, 3 Khr, Gs^Fds, Gg, Ds, Ww, Ww, Ww, Wo, Wo, Wo, Wo, Wo, Ww, Ww, Gg, Gg, Gg, Ww, Gg, Gg, Gg, Gs^Fds, Gs^Fds, Ss, Gs^Fds, Gs^Fds, Gs^Fds, Gs^Fds, Ss, Gs^Fds, Gs^Fds, Ss, Gs^Fds, Gs^Fds, Gg, Gg, Gs^Fds, Gs^Fds
Wo, Wo, Ww, Chr, Hh, Chr, Gg, Gg, Ww, Ww, Ww, Wo, Wo, Wo, Ww, Ww, Ds, Gg, Gg, Gg, Gg, Gg, Gg, Gg, Gg, Gg^Vh, Gs^Fds, Gs^Fds, Gs^Fds, Gs^Fds, Gs^Fds, Ss, Gg^Ve, Gs^Fds, Gs^Fds, Gs^Fds, Gs^Fds, Gs^Fds, Gg, Gs^Fds, Gs^Fds, Gs^Fds
Wo, Wo, Ww, Gs^Fds, Mm, Hh, Gs^Fds, Gg, Ww, Ww, Wo, Wo, Wo, Wo, Ww, Ww, Ds, Gg, Gg, Gg, Gg^Vh, Gg, Gg, Gg, Gg, Gg, Gs^Fds, Gs^Fds, Gs^Fds, Gs^Fds, Gg, Gs^Fds, Gs^Fds, Gs^Fds, Gs^Fds, Gs^Fds, Gg, Gg, Gs^Fds, Gs^Fds, Gg, Gg
Wo, Wo, Ww, Ds, Gg, Hh, Gg^Vc, Gg, Ww, Ww, Wo, Wo, Wo, Wo, Ww, Ww, Ds, Ds, Gg, Gg, Gg, Gg, Gg, Gg, Gg, Gg, Gg, Gs^Fds, Gs^Fds, Gs^Fds, Gg, Gg, Gg, Gg, Gg, Gg, Gs^Fds, Gs^Fds, Gg^Vh, Gs^Fds, Gs^Fds, Gs^Fds
Wo, Wo, Wo, Ww, Ww, Gg, Ww, Ww, Ww, Ww, Ww, Wo, Wo, Ww, Ww, Ww, Ds, Ds, Gg, Gg, Ss, Gg, Gg, Gg, Gg, Gg, Gg, Gg, Gg, Gg, Gg, Gg, Gs^Fds, Gs^Fds, Gs^Fds, Gs^Fds, Gs^Fms, Gs^Fds, Gs^Fms, Gs^Fds, Gs^Fms, Gs^Fds
Wo, Wo, Wo, Ww, Ww, Ww, Ww^Vm, Ww, Ww, Ww, Wo, Wo, Wo, Ww, Ww, Ww, Gg, Gg, Gg, Gg, Gg, Ss, Gg, Gg, Gg, Gg, Ss, Gg, Gg, Gg, Gg, Gs^Fds, Gs^Fms, Gs^Fds, Gs^Fms, Gs^Fms, Gs^Fp, Gs^Fms, Gs^Fms, Gs^Fds, Gs^Fms, Gs^Fms
Wo, Wo, Wo, Wo, Wo, Ww, Ww, Ww, Ww, Ww, Wo, Wo, Ww, Ww, Ww, Ww, Gg, Gg, Gg, Gg, Gg, Gg, Gg, Gg, Gg, Ss, Ss, Gg, Gg, Gg, Gs^Fds, Gs^Fds, Gs^Fms, Gs^Fms, Gs^Fms, Gs^Fms, Gs^Fp, Gs^Fp, Gs^Fp, Gs^Fp, Gs^Fp, Gs^Fp
Wo, Wo, Wo, Wo, Wo, Ww, Wo, Ww, Ww, Ww, Ww, Ww, Ww, Ww, Gg, Gg, Gg^Vh, Gg, Gg, Gg, Gs^Fds, Gg, Gg, Gg, Gg, Gg, Gg, Gg, Gg, Gs^Fds, Gs^Fms, Gs^Fms, Gg, Gg^Ve, Gs^Fp, Gs^Fp, Gs^Fp, Gs^Fp, Ss, Gs^Fp, Gs^Fp, Gs^Fp
Wo, Wo, Wo, Wo, Wo, Wo, Wo, Ww, Ww, Ww, Ww, Ww^Bw\, Ds, Ds, Gg, Gg, Gg, Gg, Gg, Gs^Fds, Gs^Fds, Gs^Fds, Gg, Gg, Gs^Fds, Gg, Gg, Gg, Gg, Gs^Fds, Gs^Fms, Gs^Fms, Gs^Fms, Gs^Fms, Gs^Fms, Gs^Fms, Gs^Fms, Gs^Fp, Gs^Fp, Gs^Fp, Gs^Fp, Gg
Wo, Wo, Wo, Wo, Wo, Wo, Ww, Ww, Ww, Ww, Gg, Ds, Ds, Re, Re, Gg, Gg, Gg, Gg, Gs^Fds, Gs^Fds, Gs^Fds, Gg^Ve, Gs^Fds, Gs^Fds, Gs^Fds, Gs^Fds, Gg, Gg, Gs^Fds, Gs^Fds, Gs^Fds, Gs^Fds, Gs^Fds, Gs^Fms, Gs^Fms, Gs^Fms, Gs^Fp, Gs^Fp, Gs^Fp, Gs^Fp, Gg
Wo, Wo, Wo, Wo, Wo, Wo, Ww, Ww, Ww^Bw\, Ds, Gg, Gg, Gg, Gg, Re, Gg, Gg, Gg, Gs^Fds, Gs^Fds, Gs^Fds, Gs^Fds, Gs^Fds, Gs^Fds, Gs^Fds, Gs^Fds, Gs^Fds, Gg, Gg, Gg, Gg, Gs^Fds, Gs^Fds, Gs^Fds, Gs^Fds, Gs^Fms, Gs^Fms, Gs^Fms, Gs^Fms, Gs^Fp, Gs^Fp, Gs^Fp
Wo, Wo, Wo, Wo, Wo, Wo, Wo, Ww, Ww, Ds, Ds, Gg, Gg, Re, Gg, Gg, Gg, Gg, Gs^Fds, Gs^Fds, Gs^Fds, Gs^Fds, Gs^Fds, Gs^Fds, Gs^Fds, Gs^Fds, Gs^Fds, Gs^Fds, Gg, Gg, Gg, Gg, Gg, Gs^Fds, Gg^Ve, Gs^Fds, Gs^Fms, Gs^Fms, Gs^Fp, Gs^Fp, Gs^Fp, Gs^Fp
Wo, Wo, Wo, Wo, Wo, Wo, Wo, Ww, Ww, Ds, Ds, Gg, Gg, Re, Gg, Gg, Gg, Gg, Gg, Gs^Fds, Gs^Fds, Gs^Fds, Gs^Fds, Gs^Fds, Gs^Fds, Gs^Fds, Gs^Fds, Gs^Fds, Gg, Gg, Gg^Vh, Gg, Gg, Gg, Gs^Fds, Gs^Fds, Gs^Fds, Gs^Fms, Gs^Fp, Gs^Fp, Gs^Fp, Gs^Fp
Wo, Wo, Wo, Wo, Wo, Wo, Ww, Ww, Ds, Ds, Gg, Gg, Re, Re, Gg, Gg, Gg, Gg, Ss, Gg, Gg, Gg^Ve, Gg, Gs^Fds, Gg, Gg, Gg, Gg, Gg, Gg, Gg, Gg, Gs^Fds, Gs^Fds, Gs^Fms, Gs^Fds, Gs^Fds, Gs^Fms, Gs^Fp, Gs^Fp, Gs^Fp, Gs^Fp
Wo, Wo, Wo, Wo, Wo, Wo, Ww, Ww^Bw\, Ds, Gg, Gg, Re, Gg^Ve, Gg, Gg, Gg, Gg, Gg, Gg, Gg, Gg, Gg, Re, Gg, Gg, Gg, Gg, Gg, Gg, Gg, Gg, Gg, Gs^Fds, Gs^Fms, Gs^Fms, Gs^Fms, Gs^Fms, Gs^Fms, Gs^Fp, Gg, Gs^Fp, Gs^Fp
Wo, Wo, Wo, Wo, Wo, Wo, Ww, Ww, Ds, Re, Re, Re, Gg, Gg, Gg, Gg, Re, Re, Re, Gg, Re, Re, Gg, Re, Re, Gg, Ch, Ch, Ch, 2 Gg, Gg, Gs^Fds, Gs^Fms, Gs^Fds, Gs^Fms, Gs^Fms, Gs^Fp, Gs^Fp, Gg^Ve, Gs^Fp, Gs^Fp, Gs^Fp
Wo, Wo, Wo, Wo, Ww, Ww, Ww^Bw\, Ds, Ds, Gg, Gg, Re, Re, Gg, Re, Re, Gg, Gg, Gg, Re, Gg, Gg, Gg, Gg, Gg, Re, Ch, 1 Kh, Ch, Gg, Gg, Gs^Fds, Gs^Fms, Gs^Fms, Gs^Fp, Gs^Fp, Gs^Fp, Gs^Fp, Gs^Fp, Gs^Fp, Gs^Fp, Gs^Fp
Wo, Wo, Wo, Wo, Ww, Ww, Ww, Ds, Gg, Gg, Gg, Gg, Gg, Re, Re, Gg, Gg, Gg, Gg, Gg, Gg, Gg, Gg, Gg, Gs^Fds, Gg, Gg, Ch, Gg, Gg, Gs^Fds, Gs^Fds, Gs^Fds, Gs^Fds, Gs^Fms, Ss, Gs^Fp, Gs^Fp, Gs^Fp, Gs^Fp, Gs^Fp, Gs^Fp
Wo, Wo, Wo, Ww, Ww, Ww, Ds, Ds, Gg, Gg, Gg, Gg, Ss, Gg, Re, Gg, Gg, Gg, Gg, Gg, Gg, Gg, Gg^Ve, Gs^Fds, Gs^Fds, Gg, Gg, Gg, Gg, Gg, Gs^Fds, Gs^Fms, Gs^Fms, Gs^Fds, Gs^Fms, Gs^Fp, Gs^Fp, Gs^Fp, Gs^Fp, Gs^Fp, Gs^Fp, Gs^Fp
Wo, Wo, Wo, Ww, Ww, Ww, Gg, Gg, Hh, Gg^Vh, Hh, Ss, Ss, Gg, Re, Gg, Gg, Gg, Gs^Fds, Gg, Gs^Fds, Gs^Fds, Gs^Fds, Gs^Fds, Gs^Fds, Gs^Fds, Gs^Fds, Gg, Gg, Gg, Gg, Gg^Ve, Gs^Fds, Gs^Fms, Gs^Fms, Gs^Fp, Gs^Fp, Gs^Fp, Gs^Fp, Gg, Gs^Fp, Gs^Fp
Wo, Wo, Ww, Ww, Ww, Gg, Gg, Hh, Mm, Mm, Hh, Gg, Gg, Gg, Gg, Re, Re, Gs^Fds, Gs^Fds, Gs^Fds, Gs^Fds, Gs^Fds, Gs^Fds, Gs^Fds, Gs^Fds, Gs^Fds, Gg, Gg, Gg, Gg, Gg, Gg, Gg, Gg, Gs^Fms, Gs^Fms, Gs^Fp, Gs^Fp, Gs^Fp, Gs^Fp, Gs^Fp, Gs^Fp
Wo, Wo, Ww, Ww, Ww, Gg, Gg, Hh, Mm, Mm, Hh, Gg, Gg, Gg, Gg, Re, Re, Gs^Fds, Gs^Fds, Gs^Fds, Gs^Fds, Gs^Fds, Gs^Fds, Gs^Fds, Gs^Fds, Gs^Fds, Gg, Gg, Gg, Gg, Gg, Gg, Gg, Gg, Gs^Fp, Gs^Fms, Gs^Fp, Gs^Fp, Gs^Fp, Gs^Fp, Gs^Fp, Gs^Fp
